Location,Base,Off_July_20,E21,E22,E23,Diff_23-20,percent_change_23over20
,0,2020,2021,2022,2023,3,inf
".Kaufman County, Texas",145307,147140,158313,172611,185690,38550,26.53003640567901
".Long County, Georgia",16158,16270,17108,18395,19594,3324,20.571852952098034
".Rockwall County, Texas",107844,109158,116612,123342,131307,22149,20.53799933236898
".Comal County, Texas",161493,163659,174977,184749,193928,30269,18.7432272606243
".Dawson County, Georgia",26796,27059,28498,30189,31732,4673,17.43917002537692
".Broadwater County, Montana",6775,6860,7323,7771,8032,1172,17.29889298892989
".Liberty County, Texas",91631,92479,97488,102462,108272,15793,17.23543342318648
".Custer County, Colorado",4706,4723,5063,5337,5534,811,17.233319167020824
".Sumter County, Florida",129745,130290,134870,144767,151565,21275,16.397549038498592
".Parker County, Texas",148220,149552,157088,165938,173494,23942,16.15301578734314
".Brunswick County, North Carolina",136695,138168,144843,152908,159964,21796,15.944987014887158
".St. Johns County, Florida",273422,277099,293251,307072,320110,43011,15.730628844789374
".Jackson County, Georgia",75912,76731,80374,84009,88615,11884,15.654968911371062
".Jasper County, South Carolina",28810,29150,30431,31986,33544,4394,15.251648733078794
".Hays County, Texas",241057,243968,255955,269103,280486,36518,15.149114109940804
".Ellis County, Texas",192445,194317,203187,212323,222829,28512,14.81566161760503
".Chambers County, Texas",46562,47019,48727,51309,53876,6857,14.726601091018427
".Blanco County, Texas",11375,11449,11882,12411,13048,1599,14.057142857142857
".Montgomery County, Texas",620460,625291,650755,679554,711354,86063,13.870837765528801
".Walton County, Florida",75307,75941,80021,83404,86354,10413,13.827399843308058
".Camas County, Idaho",1074,1084,1137,1169,1232,148,13.780260707635009
".Kendall County, Texas",44272,44539,46861,49019,50537,5998,13.548066498012288
".Williamson County, Texas",609006,615552,644595,672273,697191,81639,13.405286647422193
".Flagler County, Florida",115372,116028,120974,126758,131439,15411,13.357660437541172
".Wise County, Texas",68631,68947,71871,74897,78097,9150,13.332167679328583
".Canadian County, Oklahoma",154151,155434,161999,169254,175829,20395,13.230533697478448
".New Kent County, Virginia",22944,23123,23963,24952,26134,3011,13.123256624825663
".Hunt County, Texas",99953,100254,103591,108438,113347,13093,13.099156603603692
".Pender County, North Carolina",60199,60639,63020,65698,68521,7882,13.093240751507501
".Bastrop County, Texas",97218,98057,102276,106395,110778,12721,13.08502540681767
".San Juan County, Colorado",704,711,741,806,802,91,12.926136363636365
".St. Lucie County, Florida",329226,331441,344246,358886,373586,42145,12.801236840346753
".Pinal County, Arizona",426000,430187,448993,465037,484239,54052,12.688262910798123
".Horry County, South Carolina",351032,353765,366093,383147,397478,43713,12.452710863966818
".McClain County, Oklahoma",41664,41914,43535,45410,47072,5158,12.379992319508448
".Jasper County, Georgia",14590,14662,15263,15979,16455,1793,12.289239204934887
".Johnson County, Texas",180008,180964,187511,195496,202906,21942,12.189458246300164
".Polk County, Florida",725048,730158,755598,788382,818330,88172,12.160850040273194
".Lancaster County, South Carolina",96011,96588,100529,104724,108215,11627,12.110070721063211
".Osceola County, Florida",388664,391141,403990,422543,437784,46643,12.00085420826215
".Tooele County, Utah",72709,73355,76775,79955,82051,8696,11.960004951244
".Pasco County, Florida",561893,566156,585191,609141,632996,66840,11.895503236381304
".Musselshell County, Montana",4737,4750,4908,5169,5308,558,11.779607346421786
".Boundary County, Idaho",12057,12139,12620,13272,13557,1418,11.760802853114374
".Lincoln County, South Dakota",65158,65648,67992,71024,73238,7590,11.648607999017772
".Nassau County, Florida",90353,91031,94399,97826,101501,10470,11.587883080805286
".Mineral County, Montana",4531,4568,4859,5020,5090,522,11.520635621275657
".Franklin County, North Carolina",68621,69164,71832,74400,77001,7837,11.42070211742761
".Currituck County, North Carolina",28104,28405,29700,31008,31593,3188,11.34358098491318
".Iron County, Utah",57286,57713,60520,62508,64211,6498,11.343085570645533
".Washington County, Utah",180275,182015,191513,197730,202452,20437,11.336569130495077
".Collin County, Texas",1066467,1075736,1114661,1158995,1195359,119623,11.216755886492503
".Boise County, Idaho",7614,7664,8133,8360,8517,853,11.203047018649857
".Johnston County, North Carolina",215994,217808,227302,234902,241955,24147,11.179477207700215
".Petroleum County, Montana",495,499,518,521,554,55,11.11111111111111
".Waller County, Texas",56751,57285,59419,61852,63553,6268,11.044739299748022
".Lincoln County, Montana",19672,19734,20582,21510,21895,2161,10.985156567710451
".Bonner County, Idaho",47103,47403,49633,51407,52547,5144,10.920748147676369
".Adams County, Idaho",4382,4428,4623,4791,4903,475,10.839799178457325
".Billings County, North Dakota",946,933,963,1025,1034,101,10.676532769556026
".Canyon County, Idaho",231102,233013,243710,250892,257674,24661,10.671045685454908
".Fort Bend County, Texas",822797,829109,860305,888919,916778,87669,10.65499752672895
".Dallas County, Iowa",99732,100536,104174,108146,111092,10556,10.584366101151085
".Barrow County, Georgia",83504,83981,86727,89245,92792,8811,10.551590342977581
".Bryan County, Georgia",44741,45043,46974,48218,49739,4696,10.49596566907311
".Sussex County, Delaware",237375,238629,247809,256447,263509,24880,10.481305950500264
".Union County, Ohio",62783,63085,65106,66876,69637,6552,10.435946036347419
".Berkeley County, South Carolina",229826,231533,236857,244952,255217,23684,10.305187402643739
".Denton County, Texas",906419,914398,943883,977760,1007703,93305,10.293804520867281
".Juab County, Utah",11778,11819,12205,12586,13023,1204,10.222448633044658
".Burleson County, Texas",17643,17682,18109,18690,19475,1793,10.162670747605281
".Wilson County, Tennessee",147748,148659,152036,158593,163674,15015,10.162574112678344
".Gulf County, Florida",14199,14259,14462,15299,15693,1434,10.09930276780055
".Jefferson County, Idaho",30890,31080,32201,33336,34198,3118,10.093881515053415
".Limestone County, Alabama",103565,104203,107303,110868,114654,10451,10.091247042919905
".Grimes County, Texas",29299,29440,30145,31170,32384,2944,10.04812450936892
".Lamar County, Georgia",18498,18549,18697,19473,20401,1852,10.011893177640827
".Madison County, Montana",8627,8661,8953,9252,9521,860,9.968702909470267
".Lake County, Florida",383962,386216,396352,410090,424462,38246,9.960881545569613
".Loudon County, Tennessee",54887,55129,56785,58244,60591,5462,9.951354601271703
".Elbert County, Colorado",26056,26216,27159,27842,28806,2590,9.940128953024255
".Sanders County, Montana",12398,12458,12944,13384,13684,1226,9.88869172447169
".Manatee County, Florida",399714,401619,413716,429169,441095,39476,9.876061383889482
".Walton County, Georgia",96664,97158,99814,103064,106702,9544,9.873375817263923
".Effingham County, Georgia",64771,65169,66764,69034,71541,6372,9.837736023837829
".Hampshire County, Massachusetts",162316,146616,163128,162518,162502,15886,9.787081988220509
".Wagoner County, Oklahoma",80983,81384,84230,86697,89280,7896,9.75019448526234
".Lincoln County, North Carolina",86829,87220,89941,93108,95675,8455,9.737530087873868
".Charlotte County, Florida",186825,187995,194934,202582,206134,18139,9.709086043088453
".Kane County, Utah",7666,7693,7985,8203,8425,732,9.548656404904774
".Gilchrist County, Florida",17858,17882,18316,19002,19587,1705,9.547541717997536
".Banks County, Georgia",18035,18081,18538,19342,19789,1708,9.470474078181313
".Goochland County, Virginia",24730,24855,25529,26162,27197,2342,9.470279013344117
".Union County, Georgia",24628,24802,25552,26390,27124,2322,9.428292999837582
".Gem County, Idaho",19122,19272,19802,20454,21071,1799,9.40801171425583
".Custer County, South Dakota",8320,8335,8639,9021,9117,782,9.399038461538462
".Hood County, Texas",61598,62057,64293,66394,67774,5717,9.281145491736744
".Bay County, Florida",175208,174525,179520,185210,190769,16244,9.271266152230492
".Monroe County, Georgia",27956,28057,28753,29469,30625,2568,9.185863499785377
".Burnet County, Texas",49127,49483,51146,52567,53991,4508,9.176216744356463
".Hendry County, Florida",39621,39723,40215,41391,43333,3610,9.111329850331895
".Lee County, Florida",760814,765547,790888,822391,834573,69026,9.07265113417997
".Greene County, Georgia",18913,19028,19544,20111,20722,1694,8.956802199545285
".Maury County, Tennessee",100969,101826,104942,107996,110760,8934,8.84826035713932
".Hernando County, Florida",194508,195624,200693,206935,212807,17183,8.834083945133363
".Baldwin County, Alabama",231768,233227,239439,246531,253507,20280,8.750129439784612
".Carbon County, Montana",10471,10505,10889,11236,11419,914,8.728870212969152
".Marion County, Florida",375904,377472,385135,396437,409959,32487,8.642366136034733
".Louisa County, Virginia",37597,37796,39016,40030,41037,3241,8.620368646434557
".Benton County, Arkansas",284340,286618,294297,302822,311013,24395,8.579517479074347
".Lawrence County, South Dakota",25771,25844,26162,27240,28053,2209,8.571650304605953
".Granite County, Montana",3310,3312,3360,3497,3595,283,8.549848942598187
".Guadalupe County, Texas",172711,173697,177301,182702,188454,14757,8.544331281736541
".Franklin County, Idaho",14194,14282,14670,15170,15494,1212,8.538819219388474
".Caldwell County, Texas",45880,45945,46940,47849,49859,3914,8.530950305143852
".Weld County, Colorado",328987,331458,339897,350266,359442,27984,8.506111183724585
".Oneida County, Idaho",4566,4566,4605,4740,4953,387,8.475689881734558
".Montgomery County, Tennessee",219996,221281,227741,234899,239872,18591,8.450608192876235
".Flathead County, Montana",104354,104876,108769,111885,113679,8803,8.435709220537785
".Utah County, Utah",659394,663595,685973,702692,719174,55579,8.428799776764727
".Spartanburg County, South Carolina",327992,329379,335397,345948,356698,27319,8.329166565038172
".Benewah County, Idaho",9531,9576,9895,10291,10369,793,8.3202182352324
".Wilson County, Texas",49753,50052,51307,52754,54183,4131,8.303016903503305
".Sequatchie County, Tennessee",15825,15848,16448,16918,17161,1313,8.296998420221168
".Washington County, Idaho",10498,10558,10900,11147,11425,867,8.258715945894455
".Box Elder County, Utah",57664,57946,59685,61523,62684,4738,8.216564927857936
".Crook County, Oregon",24738,24929,25762,26377,26952,2023,8.177702320316921
".Lincoln County, Missouri",59578,59854,61640,63182,64699,4845,8.132196448353419
".Levy County, Florida",42909,43059,44156,45253,46545,3486,8.124169754596938
".Mineral County, Colorado",868,874,929,931,944,70,8.064516129032258
".Paulding County, Georgia",168666,169580,173989,178753,183164,13584,8.053786773860766
".Pike County, Georgia",18889,18946,19540,19955,20461,1515,8.02054105564085
".Montague County, Texas",19967,19999,20437,21079,21598,1599,8.008213552361395
".Berkeley County, West Virginia",122075,122699,126180,129379,132440,9741,7.979520786401801
".Grayson County, Texas",135543,136099,139563,143198,146907,10808,7.973853315921884
".Hudspeth County, Texas",3201,3196,3275,3416,3451,255,7.966260543580131
".Forsyth County, Georgia",251287,252901,260783,267312,272887,19986,7.953455610517059
".Pickens County, Georgia",33212,33337,34021,34825,35969,2632,7.924846441045405
".Citrus County, Florida",153849,154568,158167,162508,166696,12128,7.883054163497976
".Bandera County, Texas",20847,20998,21528,22120,22637,1639,7.862042500119921
".Meagher County, Montana",1924,1920,1958,2026,2071,151,7.848232848232849
".Idaho County, Idaho",16547,16594,17059,17637,17890,1296,7.8322354505348395
".Dolores County, Colorado",2325,2331,2375,2460,2513,182,7.827956989247312
".Delaware County, Ohio",214135,215166,221282,226526,231636,16470,7.691409624769421
".Piute County, Utah",1444,1440,1492,1493,1550,110,7.617728531855955
".Frederick County, Maryland",271710,272786,280647,287540,293391,20605,7.583452946155828
".Medina County, Texas",50746,50952,52328,53657,54797,3845,7.576951877980531
".Wakulla County, Florida",33763,33893,34270,35169,36449,2556,7.570417320735717
".Sarasota County, Florida",434010,436237,448636,462552,469013,32776,7.551899725812769
".Edgefield County, South Carolina",25645,25671,26274,26959,27607,1936,7.549229869370247
".Ravalli County, Montana",44171,44411,46084,47177,47738,3327,7.532091191052953
".Santa Rosa County, Florida",187999,189011,193750,198199,203162,14151,7.527167697700519
".Jefferson County, Montana",12082,12142,12468,12831,13048,906,7.498758483694752
".Hancock County, Indiana",79838,80180,81891,83117,86166,5986,7.497682807685563
".Llano County, Texas",21248,21290,22056,22623,22875,1585,7.459525602409639
".Lincoln County, Washington",10878,10928,11284,11613,11738,810,7.446221731936017
".Madison County, Arkansas",16519,16545,16944,17463,17775,1230,7.445971305769114
".Somervell County, Texas",9205,9205,9477,9797,9888,683,7.419880499728408
".Polk County, Texas",50125,50503,51877,53256,54186,3683,7.347630922693267
".Nye County, Nevada",51588,51963,53324,54769,55720,3757,7.282701403427154
".Marshall County, Tennessee",34327,34475,35059,35857,36961,2486,7.242112622716812
".Jefferson County, Florida",14513,14399,14494,15069,15450,1051,7.241783228829325
".Matanuska-Susitna Borough, Alaska",107068,107504,110998,113472,115239,7735,7.224380767362798
".Lampasas County, Texas",21629,21705,22224,22790,23262,1557,7.1986684543899395
".Collier County, Florida",375760,377310,387226,397516,404310,27000,7.185437513306366
".Wahkiakum County, Washington",4424,4448,4586,4688,4765,317,7.165461121157324
".Kootenai County, Idaho",171363,172785,180058,183290,185010,12225,7.133978746870678
".Union County, North Carolina",238234,239470,244259,249172,256452,16982,7.128285635131845
".Van Zandt County, Texas",59543,59758,61253,62888,64000,4242,7.124263137564449
".Camden County, North Carolina",10357,10408,10821,11090,11137,729,7.0387177754175925
".Boone County, Indiana",70809,71137,73080,74309,76120,4983,7.037241028682795
".Teton County, Idaho",11631,11735,12273,12519,12549,814,6.998538388788582
".Rutherford County, Tennessee",341483,343298,351194,360682,367101,23803,6.970478764682284
".Meigs County, Tennessee",12755,12808,13019,13258,13691,883,6.922775382203057
".Cherokee County, Georgia",266594,268156,274732,281194,286602,18446,6.919135464414053
".Brazoria County, Texas",372035,373493,379121,388234,398938,25445,6.839410270539062
".Valley County, Idaho",11744,11842,12256,12450,12644,802,6.829019073569483
".Hall County, Georgia",202889,203473,207080,212621,217267,13794,6.798791457397887
".Tyrrell County, North Carolina",3249,3241,3379,3473,3461,220,6.7713142505386275
".Butte County, Idaho",2576,2584,2666,2698,2758,174,6.754658385093168
".Haralson County, Georgia",29917,30036,30595,31355,32038,2002,6.691847444596717
".Lake County, Montana",31142,31258,32090,32853,33338,2080,6.679082910538822
".Rains County, Texas",12151,12175,12463,12836,12986,811,6.674347790305325
".Payette County, Idaho",25389,25590,26386,26929,27279,1689,6.652487297648587
".Logan County, Oklahoma",49545,49736,50900,51924,53029,3293,6.646482995256838
".Moore County, North Carolina",99745,100296,103044,105491,106898,6602,6.6188781392551
".Kershaw County, South Carolina",65409,65590,66205,67850,69905,4315,6.596951489856136
".Douglas County, Colorado",357998,360323,369783,375937,383906,23583,6.587466969089213
".Cache County, Utah",133158,133631,137458,140145,142393,8762,6.580152901064901
".Rich County, Utah",2513,2505,2600,2649,2670,165,6.565857540787904
".Wright County, Minnesota",141349,141883,145204,148118,151150,9267,6.556112883713363
".Wright County, Missouri",18188,18213,18621,19143,19403,1190,6.5427754563448435
".King George County, Virginia",26724,26826,27541,27918,28568,1742,6.518485256698099
".Hamilton County, Indiana",347469,348996,357620,365463,371645,22649,6.5182793285156375
".Clay County, North Carolina",11084,11142,11375,11615,11864,722,6.513893901118729
".Chatham County, North Carolina",76260,76664,78141,79939,81624,4960,6.504065040650407
".Hart County, Georgia",25829,25878,26319,26886,27556,1678,6.496573618800573
".Iredell County, North Carolina",186685,187683,192186,195874,199710,12027,6.442402978278919
".Newton County, Georgia",112527,112890,115341,117752,120135,7245,6.438454770854994
".Wood County, Texas",44849,45037,46076,46930,47921,2884,6.430466677071952
".Spotsylvania County, Virginia",140092,140604,144003,146828,149588,8984,6.4129286468891875
".Pend Oreille County, Washington",13400,13502,13891,14138,14361,859,6.41044776119403
".Carroll County, Georgia",119151,119498,121595,124530,127098,7600,6.378460944515782
".Madison County, Georgia",30128,30276,30887,31450,32191,1915,6.3562134891131175
".Fentress County, Tennessee",18487,18533,18835,19335,19696,1163,6.29090712392492
".Webster County, Missouri",39089,39013,39601,40366,41472,2459,6.290772340044513
".Jackson County, Tennessee",11617,11633,11771,12015,12363,730,6.283894292846689
".Shoshone County, Idaho",13168,13199,13615,13935,14026,827,6.280376670716889
".Morgan County, Georgia",20097,20201,20650,21024,21460,1259,6.264616609444196
".Bear Lake County, Idaho",6370,6367,6567,6730,6766,399,6.263736263736264
".Suffolk city, Virginia",94370,94750,96337,98426,100659,5909,6.261523789339833
".Coweta County, Georgia",146163,146747,149973,152879,155892,9145,6.256713395318925
".Volusia County, Florida",553537,555776,566368,579665,590357,34581,6.247278863020901
".King William County, Virginia",17811,17918,18243,18529,19030,1112,6.243332771882545
".Lincoln County, Wyoming",19582,19658,20173,20671,20880,1222,6.24042487999183
".Cass County, North Dakota",184517,184876,189377,192713,196362,11486,6.224900686657598
".Highlands County, Florida",101239,101349,103279,105649,107614,6265,6.188326633016921
".Clay County, Florida",218248,218951,222648,226634,232439,13488,6.180125361973535
".Hendricks County, Indiana",174778,175596,179800,183119,186387,10791,6.174118024007598
".Walker County, Texas",76406,76553,78348,79678,81268,4715,6.1709813365442505
".Lincoln County, Idaho",5127,5134,5285,5385,5450,316,6.163448410376438
".Sanpete County, Utah",28437,28526,29124,29691,30277,1751,6.157470900587263
".Catron County, New Mexico",3577,3606,3710,3793,3825,219,6.122448979591836
".Owyhee County, Idaho",11915,11996,12356,12645,12722,726,6.093159882501049
".Perry County, Tennessee",8382,8381,8493,8705,8891,510,6.084466714387974
".Fall River County, South Dakota",6969,6970,7213,7397,7393,423,6.069737408523461
".Macon County, Tennessee",25217,25267,25673,26214,26793,1526,6.051473212515367
".Aransas County, Texas",23829,23932,24510,24963,25374,1442,6.051449913970372
".Ouray County, Colorado",4880,4882,5063,5103,5176,294,6.024590163934426
".Williamson County, Tennessee",247724,249552,256065,260738,264460,14908,6.01798776057225
".Orange County, Virginia",36186,36397,37220,38055,38574,2177,6.016138838224728
".Lewis County, Idaho",3526,3527,3690,3725,3739,212,6.012478729438457
".Washington County, Arkansas",245866,246774,251767,256682,261549,14775,6.009370958164204
".Wasatch County, Utah",34782,35055,36246,36597,37144,2089,6.005980104651831
".Lemhi County, Idaho",7979,7962,8160,8284,8441,479,6.003258553703471
".Suwannee County, Florida",43472,43524,44125,45405,46130,2606,5.994663231505337
".Oglethorpe County, Georgia",14826,14869,15187,15531,15754,885,5.969243221367868
".Beaufort County, South Carolina",187106,187815,191997,196147,198979,11164,5.966671298622171
".Liberty County, Georgia",65271,65317,66800,67919,69210,3893,5.964363959491964
".Hill County, Texas",35870,35964,36378,37266,38101,2137,5.957624756063563
".Allen County, Kentucky",20580,20574,20839,21283,21788,1214,5.898931000971817
".Custer County, Idaho",4279,4271,4446,4518,4523,252,5.889226454779154
".Robertson County, Kentucky",2195,2184,2257,2247,2313,129,5.876993166287016
".Greenville County, South Carolina",525543,527249,534648,547845,558036,30787,5.858131494473335
".Keya Paha County, Nebraska",769,760,796,805,805,45,5.851755526657997
".Indian River County, Florida",159791,160446,163869,167267,169795,9349,5.850767565131953
".Lyon County, Kentucky",8685,8679,8435,9099,9187,508,5.84916522740357
".Glades County, Florida",12128,12078,12266,12463,12786,708,5.8377308707124005
".Warren County, Missouri",35528,35732,36551,37290,37806,2074,5.837649178113038
".Benton County, Missouri",19392,19422,19934,20233,20552,1130,5.827145214521452
".Uintah County, Utah",35612,35672,36229,37104,37747,2075,5.826687633382006
".Camden County, Georgia",54772,54931,55786,56971,58118,3187,5.818666471919959
".Chaffee County, Colorado",19476,19484,19741,20265,20617,1133,5.817416307249949
".Fremont County, Idaho",13387,13419,13591,14017,14196,777,5.804138343168746
".Brevard County, Florida",606621,608775,617900,630707,643979,35204,5.803293984217493
".Pennington County, South Dakota",109226,109566,111886,114306,115903,6337,5.801732188306814
".Christian County, Missouri",88841,89285,91616,93122,94422,5137,5.782240181897998
".Harnett County, North Carolina",133571,133757,135586,138478,141477,7720,5.77969768886959
".Kendall County, Illinois",131868,132355,135015,137494,139976,7621,5.7792641125974455
".Crook County, Wyoming",7176,7178,7308,7419,7592,414,5.769230769230769
".Lee County, North Carolina",63280,63434,64052,65543,67059,3625,5.7285082174462705
".Archuleta County, Colorado",13355,13424,13806,13989,14189,765,5.728191688506177
".Gallatin County, Montana",118958,119597,123098,124938,126409,6812,5.726390827014577
".Bryan County, Oklahoma",46071,46330,47126,48038,48967,2637,5.723774174643485
".Madison County, Alabama",388154,390503,396671,403605,412600,22097,5.692843562091335
".Habersham County, Georgia",46034,46142,46748,47465,48757,2615,5.680583916235825
".San Benito County, California",64210,64530,66709,67643,68175,3645,5.676685874474381
".Cabarrus County, North Carolina",225791,227219,231788,235909,240016,12797,5.667630685014018
".Bell County, Texas",370657,372258,380399,387454,393193,20935,5.64807895169928
".Franklin County, Georgia",23424,23471,23510,24146,24782,1311,5.596823770491803
".Delta County, Texas",5231,5228,5344,5413,5520,292,5.582106671764481
".DeSoto County, Florida",33976,34086,34333,35320,35979,1893,5.5715799387803155
".Caroline County, Virginia",30881,30921,31405,31940,32640,1719,5.566529581295942
".Butte County, South Dakota",10244,10293,10542,10790,10863,570,5.564232721593128
".New Hanover County, North Carolina",225707,226326,230019,235784,238852,12526,5.549672805894367
".Montmorency County, Michigan",9158,9170,9302,9557,9678,508,5.547062677440489
".Bulloch County, Georgia",79646,79922,80671,83038,84327,4405,5.530723451271878
".Cumberland County, Tennessee",61151,61379,62391,63482,64760,3381,5.528936566859087
".Archer County, Texas",8555,8556,8702,8849,9029,473,5.528930450029223
".Fayette County, Tennessee",41721,41870,42616,43338,44175,2305,5.524795666450948
".Trousdale County, Tennessee",11609,11635,11605,12077,12271,636,5.47850805409596
".Keweenaw County, Michigan",2047,2060,2108,2155,2172,112,5.471421592574499
".Upshur County, Texas",40894,41046,41835,42454,43281,2235,5.46534944001565
".Powhatan County, Virginia",30343,30450,31230,31585,32105,1655,5.454305770688462
".Atascosa County, Texas",48977,49128,49817,50736,51784,2656,5.4229536312963225
".Jackson County, North Carolina",43108,42237,42587,43922,44574,2337,5.421267514150506
".Lewis and Clark County, Montana",70970,71177,72507,73784,75011,3834,5.402282654642806
".Sumner County, Tennessee",196285,197416,200505,203721,207994,10578,5.389102580431516
".Douglas County, Missouri",11576,11606,11749,11981,12228,622,5.37318590186593
".Beaverhead County, Montana",9374,9382,9553,9747,9885,503,5.365905696607638
".Warren County, Kentucky",134558,135028,137225,140046,142229,7201,5.351595594464841
".Bonneville County, Idaho",123964,124737,128064,129543,131366,6629,5.347520247813882
".Jefferson County, Tennessee",54682,54916,55547,56660,57838,2922,5.343623130097655
".Ada County, Idaho",494961,498278,513025,519004,524673,26395,5.332743387862882
".James City County, Virginia",78253,78487,79991,81483,82654,4167,5.325035461899224
".Columbia County, Georgia",156013,156865,159662,162471,165162,8297,5.318146564709352
".Clearwater County, Idaho",8728,8750,8925,9035,9214,464,5.316223648029331
".Navarro County, Texas",52623,52838,53637,54687,55635,2797,5.3151663721186555
".Bedford County, Tennessee",50237,50385,51184,51964,53055,2670,5.3148078109759735
".Twin Falls County, Idaho",90049,90372,92394,93821,95156,4784,5.312663105642484
".Radford city, Virginia",16069,16119,16527,16719,16971,852,5.302134544775655
".Henry County, Georgia",240703,241852,245085,248472,254613,12761,5.3015541974964995
".Ozark County, Missouri",8552,8517,8785,8954,8970,453,5.297006548175865
".Wake County, North Carolina",1129352,1130483,1152301,1170778,1190275,59792,5.294363493401526
".Lanier County, Georgia",9883,9929,10051,10177,10452,523,5.291915410300517
".Lake County, Michigan",12098,12094,12274,12651,12734,640,5.2901306000991895
".Texas County, Missouri",24492,24324,24868,25304,25619,1295,5.287440796994937
".Lyon County, Nevada",59236,59465,60961,61628,62583,3118,5.263690998716997
".Butts County, Georgia",25436,25549,26164,26745,26887,1338,5.260261047334486
".Bartow County, Georgia",108897,109314,110936,112815,115041,5727,5.259098046778148
".Robertson County, Tennessee",72805,72953,74031,75398,76776,3823,5.251012979877755
".Spencer County, Kentucky",19433,19511,19887,20212,20531,1020,5.248803581536562
".Throckmorton County, Texas",1441,1451,1503,1539,1526,75,5.20471894517696
".Isle of Wight County, Virginia",38611,38707,39391,40135,40711,2004,5.190230763253996
".Oconee County, Georgia",41798,42016,43034,43624,44182,2166,5.182066127565912
".Van Buren County, Tennessee",6168,6174,6293,6430,6493,319,5.171854734111543
".Heard County, Georgia",11409,11444,11532,11716,12034,590,5.171355947059339
".DeKalb County, Tennessee",20078,20189,20500,21002,21225,1036,5.159876481721287
".George County, Mississippi",24347,24364,24788,25199,25619,1255,5.154639175257731
".Freestone County, Texas",19439,19440,19788,20032,20441,1001,5.14944184371624
".Livingston Parish, Louisiana",142282,142834,146121,148056,150145,7311,5.1383871466524225
".Leon County, Texas",15717,15732,16009,16220,16538,806,5.128205128205128
".Austin County, Texas",30165,30132,30431,31070,31677,1545,5.121829935355544
".San Jacinto County, Texas",27397,27533,27811,28340,28936,1403,5.12099864948717
".Garrard County, Kentucky",16946,16963,17366,17566,17829,866,5.110350525197687
".Rogers County, Oklahoma",95236,95386,96871,99060,100248,4862,5.105212314670923
".Chesterfield County, Virginia",364061,365311,370931,378290,383876,18565,5.099420152117365
".York County, South Carolina",282089,284028,289201,294201,298320,14292,5.06648610899397
".Harris County, Georgia",34666,34898,35589,36257,36654,1756,5.065482028500548
".Hickory County, Missouri",8274,8299,8572,8575,8718,419,5.064056079284505
".Morgan County, Utah",12294,12382,12662,12837,13000,618,5.0268423621278675
".Yavapai County, Arizona",236210,237217,242352,246230,249081,11864,5.02264933745396
".Warren County, Iowa",52398,52591,53485,54303,55205,2614,4.988740028245353
".Jerome County, Idaho",24242,24270,24738,25244,25479,1209,4.987212276214834
".Skamania County, Washington",12033,12041,12209,12455,12640,599,4.97797722928613
".Faulkner County, Arkansas",123493,123820,125608,127565,129951,6131,4.964653867020803
".Fannin County, Texas",35661,35801,36723,37075,37571,1770,4.96340540085808
".Queen Anne's County, Maryland",49876,50033,50922,51720,52508,2475,4.962306520170022
".Hancock County, Tennessee",6661,6627,6794,6846,6956,329,4.939198318570785
".Lexington County, South Carolina",293977,295047,300650,305105,309528,14481,4.92589556325835
".Sheridan County, Wyoming",30917,31000,31653,32035,32519,1519,4.913154575152828
".Randall County, Texas",140755,141347,144055,146244,148255,6908,4.907818549962701
".Stanly County, North Carolina",62505,62642,63100,64231,65699,3057,4.890808735301176
".Saunders County, Nebraska",22281,22374,22832,23177,23463,1089,4.887572371078497
".Stafford County, Virginia",156939,157765,161568,163169,165428,7663,4.882788854268219
".Cooke County, Texas",41670,41748,42398,43048,43782,2034,4.881209503239741
".Lee County, Alabama",174247,174754,177596,180698,183215,8461,4.855750744632619
".Stevens County, Washington",46450,46591,47619,48283,48837,2246,4.835306781485468
".Roane County, Tennessee",53396,53517,54088,55129,56096,2579,4.829949808974455
".Dorchester County, South Carolina",161329,162043,163452,166050,169833,7790,4.8286420916264285
".Lumpkin County, Georgia",33488,33641,32843,34706,35258,1617,4.828595317725752
".Bingham County, Idaho",47983,48097,48929,49973,50395,2298,4.789196173644832
".Columbia County, Florida",69694,69740,69932,71870,73063,3323,4.767985766350045
".Brookings County, South Dakota",34370,34343,34696,35491,35980,1637,4.76287459994181
".Monroe County, Tennessee",46248,46394,46649,47680,48594,2200,4.756962463241654
".Milam County, Texas",24747,24774,25212,25622,25951,1177,4.756132056410878
".Power County, Idaho",7876,7879,7975,8136,8253,374,4.748603351955307
".Hillsborough County, Florida",1459779,1466255,1484607,1513473,1535564,69309,4.747910471379572
".Sherburne County, Minnesota",97189,97593,99211,100540,102206,4613,4.746421920176152
".Grainger County, Tennessee",23530,23569,23800,24185,24681,1112,4.725881852953676
".Putnam County, Tennessee",79853,80071,81250,82470,83844,3773,4.724932062665147
".Orange County, North Carolina",148717,143602,148693,150253,150626,7024,4.723064612653563
".Aiken County, South Carolina",168806,169168,171247,174228,177130,7962,4.716656990865253
".Smith County, Texas",233484,234199,237182,241995,245209,11010,4.715526545716195
".Clay County, Texas",10220,10257,10311,10499,10738,481,4.706457925636008
".McIntosh County, Georgia",10973,10985,11054,11183,11501,516,4.702451471794404
".Saguache County, Colorado",6368,6389,6511,6627,6688,299,4.6953517587939695
".Minnehaha County, South Dakota",197207,197695,199904,203845,206930,9235,4.68289665174157
".Saline County, Arkansas",123430,123826,125382,127415,129574,5748,4.656890545248319
".Houston County, Georgia",163642,164356,167228,169775,171974,7618,4.6552840957700345
".Stone County, Missouri",31082,31212,31592,32134,32658,1446,4.652210282478605
".Northumberland County, Virginia",11839,11841,12052,12278,12391,550,4.645662640425711
".Dixie County, Florida",16756,16687,16933,17120,17465,778,4.643112914776797
".Morgan County, Missouri",21002,20995,21430,21786,21970,975,4.642415008094467
".Big Horn County, Wyoming",11523,11484,11643,11879,12018,534,4.634209841187191
".Hamlin County, South Dakota",6167,6166,6264,6394,6451,285,4.621371817739582
".Franklin County, Maine",29452,29468,30258,30595,30828,1360,4.617683009642809
".Yuba County, California",81578,81958,83227,84353,85722,3764,4.613989065679473
".Scott County, Kentucky",57160,57531,58316,59077,60168,2637,4.613365990202939
".Camp County, Texas",12464,12428,12602,12721,13000,572,4.589216944801027
".Jack County, Texas",8473,8487,8550,8764,8875,388,4.579251740823794
".Lafayette County, Mississippi",55814,55913,56902,57730,58467,2554,4.575912853405955
".Callahan County, Texas",13705,13747,14098,14247,14374,627,4.574972637723459
".Sarpy County, Nebraska",190597,191167,193826,196427,199886,8719,4.574573576708972
".Gilmer County, Georgia",31349,31427,32106,32403,32860,1433,4.571118695971163
".Henderson County, Texas",82147,82403,83653,84490,86158,3755,4.5710738067123575
".Pike County, Pennsylvania",58546,58574,59997,60576,61247,2673,4.565640692788577
".Deschutes County, Oregon",198251,199464,205283,206483,208513,9049,4.564415816313662
".White County, Tennessee",27354,27444,27541,28000,28692,1248,4.562404035972801
".Palo Pinto County, Texas",28413,28452,28742,29322,29747,1295,4.557772850455778
".Grady County, Oklahoma",54803,54881,55595,56648,57375,2494,4.550845756619163
".Union County, Tennessee",19804,19845,20013,20473,20741,896,4.524338517471218
".Hamilton County, Texas",8221,8248,8230,8313,8619,371,4.512832988687507
".Frederick County, Virginia",91418,91870,93959,94808,95994,4124,4.511146601325778
".Pine County, Minnesota",28889,28899,29414,29533,30197,1298,4.4930596420782996
".Okeechobee County, Florida",39642,39652,40031,40373,41427,1775,4.477574289894556
".Wayne County, Utah",2485,2503,2560,2634,2614,111,4.466800804828973
".Sandoval County, New Mexico",148834,149290,151478,153597,155936,6646,4.465377534703092
".Mohave County, Arizona",213276,214185,217164,220905,223682,9497,4.45291547103284
".Platte County, Missouri",106733,107193,108744,110570,111940,4747,4.447546681907189
".McCormick County, South Carolina",9528,9518,9764,9741,9941,423,4.4395465994962215
".Highland County, Virginia",2232,2240,2239,2296,2339,99,4.435483870967742
".Cullman County, Alabama",87857,88136,89639,90663,92016,3880,4.416267343524136
".Clarke County, Virginia",14787,14814,14940,15331,15466,652,4.409278420233989
".Appomattox County, Virginia",16116,16154,16398,16703,16864,710,4.405559692231323
".Carroll County, New Hampshire",50105,50246,51741,52154,52448,2202,4.3947709809400255
".Lewis County, Washington",82143,82553,84569,85357,86154,3601,4.383818462924412
".McMinn County, Tennessee",53270,53343,53921,54695,55678,2335,4.383330204617984
".Lawrence County, Tennessee",44160,44181,44768,45502,46114,1933,4.377264492753623
".Duchesne County, Utah",19604,19620,19792,20142,20477,857,4.371556825137727
".Trinity County, Texas",13602,13634,13832,13993,14228,594,4.3670048522276135
".St. Clair County, Missouri",9283,9347,9413,9595,9752,405,4.362813745556393
".Brazos County, Texas",233848,234505,237612,241931,244703,10198,4.360952413533577
".Anderson County, South Carolina",203724,204195,206885,209652,213076,8881,4.359329288645422
".Placer County, California",404745,405927,413047,418074,423561,17634,4.356817255308898
".Putnam County, Georgia",22049,22170,22614,22933,23129,959,4.349403601070343
".Isanti County, Minnesota",41139,41396,41962,42711,43182,1786,4.341379226524709
".Coffee County, Tennessee",57888,58139,58983,59779,60633,2494,4.308319513543394
".Moore County, Tennessee",6468,6470,6651,6716,6748,278,4.298082869511441
".Sherman County, Oregon",1864,1871,1907,1947,1951,80,4.291845493562231
".Blount County, Tennessee",135287,135657,137611,139810,141456,5799,4.2864428954740665
".Fluvanna County, Virginia",27252,27294,27797,28117,28462,1168,4.285923968883018
".Daggett County, Utah",936,952,982,1015,992,40,4.273504273504273
".Henry County, Alabama",17141,17169,17433,17670,17899,730,4.258794702759466
".St. Clair County, Alabama",91468,91657,92874,93881,95552,3895,4.2583198495648755
".Cass County, Minnesota",30090,30168,30682,31308,31446,1278,4.247258225324027
".Hoke County, North Carolina",52074,52236,53179,53691,54446,2210,4.243960517724776
".Franklin County, Tennessee",42770,42845,43196,44119,44654,1809,4.229600187046995
".Dickson County, Tennessee",54307,54440,55174,55727,56729,2289,4.2149262526009545
".Latah County, Idaho",39523,39638,40400,40924,41301,1663,4.207676542772563
".Knox County, Tennessee",478966,480516,485941,495380,500669,20153,4.207605550289582
".Alamance County, North Carolina",171426,171960,173968,176618,179165,7205,4.202979711362337
".Crawford County, Michigan",12991,12992,13277,13434,13538,546,4.202909706720037
".Lee County, Texas",17483,17506,17679,17971,18240,734,4.198364125150146
".Culpeper County, Virginia",52550,52768,53772,54290,54973,2205,4.196003805899143
".Pondera County, Montana",5903,5878,6018,6092,6125,247,4.184313061155344
".Izard County, Arkansas",13578,13602,13921,14029,14169,567,4.175872735307115
".Madera County, California",156258,156345,158966,160329,162858,6513,4.168106592942442
".Ferry County, Washington",7180,7198,7290,7468,7497,299,4.164345403899721
".San Juan County, Washington",17786,17826,18618,18672,18566,740,4.160575733723153
".Pickaway County, Ohio",58545,58656,58765,60007,61086,2430,4.15065334358186
".Garfield County, Utah",5086,5103,5126,5258,5314,211,4.148643334644121
".Mecklenburg County, North Carolina",1115534,1117423,1126283,1144075,1163701,46278,4.148506455204413
".Douglas County, Washington",42933,43029,43837,44223,44798,1769,4.120373605385135
".Marshall County, Oklahoma",15302,15340,15552,15921,15970,630,4.117108874656908
".Kent County, Delaware",181858,182315,185043,187758,189789,7474,4.109799953810116
".Alleghany County, North Carolina",10883,10895,11079,11193,11342,447,4.10732334834145
".Fayette County, Texas",24433,24471,24690,24934,25474,1003,4.105103753120779
".Wayne County, Georgia",30139,30142,30220,30737,31373,1231,4.084408905404957
".Bosque County, Texas",18232,18252,18499,18707,18996,744,4.0807371654234315
".Shelby County, Alabama",223038,223912,227453,230033,233000,9088,4.074641989257436
".Waynesboro city, Virginia",22196,22279,22606,22799,23182,903,4.068300594701748
".Turner County, South Dakota",8663,8675,8679,8888,9027,352,4.063257532032783
".Antrim County, Michigan",23426,23458,23879,24265,24409,951,4.0595919064287544
".Cumberland County, Pennsylvania",259479,260258,265537,268532,270738,10480,4.038862489835401
".Madison County, Kentucky",92705,92993,93474,95151,96735,3742,4.036459737878216
".Piscataquis County, Maine",16801,16808,17217,17403,17486,678,4.035474078923873
".Park County, Colorado",17392,17418,17744,17921,18117,699,4.019089236430543
".Fairfax city, Virginia",24147,24177,24353,24752,25144,967,4.004638257340456
".St. Tammany Parish, Louisiana",264571,265000,270147,273237,275583,10583,4.000060475259949
".Morgan County, Kentucky",13729,13735,13689,14146,14283,548,3.991550732027096
".Davie County, North Carolina",42720,42903,43652,44115,44599,1696,3.9700374531835205
".Midland County, Texas",169986,170362,168257,172019,177108,6746,3.9685621168802134
".Park County, Montana",17190,17223,17515,17753,17903,680,3.955788248981966
".Washington County, Minnesota",267557,268389,272865,276169,278936,10547,3.9419637684680273
".Livingston County, Missouri",14548,13985,14191,14335,14557,572,3.9318119329117405
".Coffee County, Alabama",53459,53549,54199,54840,55643,2094,3.91702052039881
".Washington County, Tennessee",133003,133219,133460,136147,138420,5201,3.910438110418562
".Towns County, Georgia",12488,12547,12880,12961,13035,488,3.9077514413837284
".Kenai Peninsula Borough, Alaska",58801,58942,59946,60611,61223,2281,3.879185728133875
".Warren County, Tennessee",40946,41052,41468,42001,42638,1586,3.8733942265422754
".DeSoto County, Mississippi",185312,186122,189004,191144,193247,7125,3.8448670350543948
".Pottawatomie County, Kansas",25343,25411,25873,26292,26382,971,3.8314327427692065
".Shackelford County, Texas",3107,3110,3191,3212,3229,119,3.8300611522368846
".Cherokee County, North Carolina",28769,28858,29194,29459,29959,1101,3.8270360457436827
".Gaston County, North Carolina",227943,228532,231277,233970,237242,8710,3.82113072127681
".Cleburne County, Alabama",15057,15064,15156,15372,15639,575,3.81882181045361
".Gaines County, Texas",21597,21699,21878,22140,22523,824,3.815344723804232
".Marion County, Arkansas",16828,16873,16984,17289,17514,641,3.809127644402187
".Torrance County, New Mexico",15052,15062,15313,15383,15633,571,3.793515811852245
".Cassia County, Idaho",24692,24760,25244,25644,25696,936,3.790701441762514
".Sharp County, Arkansas",17274,17314,17691,17836,17968,654,3.786036818339701
".Stewart County, Tennessee",13656,13706,13808,13994,14222,516,3.7785588752196833
".Anderson County, Tennessee",77147,77320,77615,78929,80234,2914,3.7772045575330213
".Cocke County, Tennessee",35999,36045,36364,36849,37404,1359,3.775104864024001
".Oscoda County, Michigan",8220,8235,8320,8391,8545,310,3.7712895377128954
".Benton County, Washington",206868,207419,210599,212829,215219,7800,3.7705203318057894
".Minidoka County, Idaho",21582,21668,21944,22208,22480,812,3.7623945880826613
".Jessamine County, Kentucky",52990,53024,53603,54236,55017,1993,3.7610869975467067
".Southeast Fairbanks Census Area, Alaska",6807,6821,7007,7016,7077,256,3.7608344351402963
".Dallas County, Missouri",17066,17128,17336,17587,17768,640,3.75014649009727
".Adams County, Wisconsin",20647,20677,20837,21252,21449,772,3.739041991572625
".Okanogan County, Washington",42090,42139,42772,43460,43712,1573,3.7372297457828463
".Real County, Texas",2759,2751,2817,2832,2854,103,3.733236679956506
".Harrison County, Kentucky",18692,18719,18957,19105,19415,696,3.7235180826021828
".Fairfield County, Ohio",158908,159448,161209,162956,165360,5912,3.7203916731693814
".Madison County, North Carolina",21192,21287,21728,21881,22071,784,3.6995092487731216
".West Baton Rouge Parish, Louisiana",27202,27262,27798,28034,28266,1004,3.690905080508786
".Polk County, Missouri",31524,31617,32042,32659,32780,1163,3.6892526329146045
".Yuma County, Arizona",205002,205659,207284,208874,213221,7562,3.6887445000536583
".Gillespie County, Texas",26726,26748,27293,27501,27733,985,3.685549652024246
".Oldham County, Kentucky",67607,67693,68238,69444,70183,2490,3.6830505716863637
".Bent County, Colorado",5648,5473,5339,5439,5681,208,3.6827195467422094
".Warren County, Ohio",242346,243228,246828,249735,252148,8920,3.6806879420332916
".Elmore County, Idaho",28665,28669,28978,29391,29724,1055,3.680446537589395
".Ascension Parish, Louisiana",126499,126978,128571,130485,131632,4654,3.6790804670392654
".Spalding County, Georgia",67312,67471,67765,69008,69946,2475,3.676907535060613
".Sevier County, Utah",21508,21554,21894,22043,22344,790,3.6730518876697045
".Hopkins County, Texas",36791,36827,37210,37793,38172,1345,3.655785382294583
".Lewis County, Tennessee",12583,12606,12852,12912,13066,460,3.6557259794961454
".Valencia County, New Mexico",76207,76374,77315,78201,79141,2767,3.63090004855197
".Wallowa County, Oregon",7392,7406,7558,7650,7674,268,3.6255411255411256
".Mille Lacs County, Minnesota",26473,26468,26913,27295,27427,959,3.6225588335285006
".Judith Basin County, Montana",2016,2020,2038,2079,2093,73,3.6210317460317465
".Madison County, Florida",17972,17869,18099,18230,18519,650,3.6167371466726017
".Costilla County, Colorado",3497,3502,3613,3615,3628,126,3.6030883614526736
".Park County, Wyoming",29627,29669,30141,30505,30735,1066,3.5980693286529175
".Bexar County, Texas",2009316,2015501,2030981,2060191,2087679,72178,3.5921676829328986
".Bannock County, Idaho",87019,87276,88515,89625,90400,3124,3.5900205702202967
".Merced County, California",281205,281830,284610,290210,291920,10090,3.5881296563005636
".Hanover County, Virginia",109977,110202,111783,112860,114148,3946,3.588022950253235
".Mason County, Washington",65723,66034,67246,68171,68389,2355,3.5832204859790338
".Tompkins County, New York",105737,99772,105966,104299,103558,3786,3.580582010081618
".Jefferson County, Oregon",24508,24581,25105,25324,25454,873,3.562102170719765
".Jones County, Texas",19654,19682,19811,20271,20381,699,3.556527933245141
".Macon County, North Carolina",37019,37098,37470,37969,38412,1314,3.5495286204381533
".Charleston County, South Carolina",408481,409899,414514,419350,424367,14468,3.5419028057608557
".Gordon County, Georgia",57544,57722,58239,58855,59757,2035,3.536424301404143
".Meade County, South Dakota",29847,29899,30289,30702,30954,1055,3.534693604047308
".Franklin County, Texas",10355,10369,10497,10665,10735,366,3.5345243843553837
".Lincoln County, Maine",35248,35263,36024,36285,36507,1244,3.5292782569223786
".Putnam County, Florida",73319,73372,74095,74736,75955,2583,3.52296130607346
".Carver County, Minnesota",106919,107297,108859,110120,111057,3760,3.516680851859819
".Eureka County, Nevada",1852,1852,1908,1863,1917,65,3.509719222462203
".Georgetown County, South Carolina",63402,63509,63925,64669,65731,2222,3.504621305321599
".Durham County, North Carolina",324846,325567,329849,333292,336892,11325,3.4862673389852423
".Kimble County, Texas",4282,4293,4348,4420,4442,149,3.4796823914058854
".Oxford County, Maine",57765,57898,58692,59458,59905,2007,3.4744222279927293
".Erath County, Texas",42543,42719,43381,43837,44195,1476,3.469430928707425
".Jefferson County, West Virginia",57705,57785,58541,59001,59787,2002,3.4693700719175116
".Polk County, North Carolina",19335,19390,19714,20012,20060,670,3.4652185156452027
".Johnson County, Wyoming",8450,8467,8624,8719,8759,292,3.455621301775148
".Johnson County, Indiana",161763,162237,164394,165686,167819,5582,3.4507272985787854
".Gloucester County, Virginia",38715,38722,39174,39550,40057,1335,3.4482758620689653
".McIntosh County, Oklahoma",18944,18950,19249,19403,19603,653,3.4470016891891895
".Hamilton County, Tennessee",366209,367251,369005,374602,379864,12613,3.444208088823595
".Hubbard County, Minnesota",21350,21397,21749,21963,22132,735,3.4426229508196724
".Pierce County, Georgia",19715,19747,19975,20190,20425,678,3.4390058331219886
".Cannon County, Tennessee",14507,14565,14537,14807,15063,498,3.432825532501551
".Hickman County, Tennessee",24911,24972,25080,25481,25826,854,3.428204407691381
".Kanabec County, Minnesota",16029,16053,16170,16449,16602,549,3.425042111173498
".Hawaii County, Hawaii",200635,200744,203875,206348,207615,6871,3.424626809878635
".Cherokee County, Texas",50413,50493,51150,51432,52217,1724,3.419752841528971
".Vilas County, Wisconsin",23046,23097,23508,23742,23885,788,3.4192484596025343
".Yellowstone County, Montana",164731,165218,167438,169870,170843,5625,3.414657836108565
".Klickitat County, Washington",22730,22814,23167,23303,23589,775,3.4095908490981084
".Weber County, Utah",262218,262988,266569,269460,271926,8938,3.4086142064999354
".Hardin County, Texas",56235,56350,57133,57840,58261,1911,3.3982395305414776
".Clark County, Indiana",121093,121360,122895,124222,125467,4107,3.391608102863089
".Newton County, Missouri",58647,58692,59440,60096,60677,1985,3.3846573567275393
".Greene County, Virginia",20554,20607,21004,21015,21301,694,3.3764717329960106
".Washington County, Texas",35802,35804,35947,36368,37007,1203,3.360147477794537
".Fredericksburg city, Virginia",27973,27991,28437,28648,28928,937,3.3496585993636723
".Huerfano County, Colorado",6817,6827,6934,7097,7055,228,3.3445797271527065
".Frontier County, Nebraska",2515,2501,2544,2611,2585,84,3.3399602385685885
".Rockingham County, Virginia",83763,83774,84518,85414,86568,2794,3.3356016379547055
".Garfield County, Montana",1172,1172,1208,1218,1211,39,3.3276450511945397
".Duval County, Florida",995566,997784,1002774,1017011,1030822,33038,3.318514292372379
".Davidson County, North Carolina",168927,169203,170717,172380,174804,5601,3.315633380099096
".Breckinridge County, Kentucky",20435,20447,20687,20961,21124,677,3.3129434793246877
".Hawkins County, Tennessee",56724,56721,57202,57903,58600,1879,3.312530851138848
".Cass County, Missouri",107823,108161,109780,110357,111732,3571,3.3119093328881593
".Tangipahoa Parish, Louisiana",133162,133654,135488,136799,138064,4410,3.3117556059536506
".Lyon County, Iowa",11936,11930,12040,12177,12324,394,3.300938337801609
".Mecosta County, Michigan",39706,39790,40048,40782,41099,1309,3.2967309726489704
".Miller County, Missouri",24727,24775,24941,25403,25590,815,3.2959922352084767
".Morgan County, West Virginia",17066,17087,17300,17435,17649,562,3.293097386616665
".Bayfield County, Wisconsin",16216,16237,16322,16659,16769,532,3.2807104094721264
".White County, Georgia",27997,28108,28389,28804,29026,918,3.2789227417223272
".Overton County, Tennessee",22509,22590,22831,22993,23327,737,3.2742458572126703
".Silver Bow County, Montana",35132,35210,35502,35947,36360,1150,3.273369008311511
".Grant County, Washington",99125,99441,100427,101580,102678,3237,3.265573770491803
".Ocean County, New Jersey",637235,638465,649825,655663,659197,20732,3.2534308379169383
".Delaware County, Oklahoma",40399,40392,40970,41480,41703,1311,3.2451298299462863
".Cedar County, Missouri",14187,14212,14515,14601,14672,460,3.2424050186790723
".Loudoun County, Virginia",420957,422705,428764,432792,436347,13642,3.2407110464964353
".Fayette County, Georgia",119181,119491,120715,121981,123351,3860,3.2387712806571516
".Toole County, Montana",4975,4972,4992,5077,5133,161,3.2361809045226133
".Jackson County, Florida",47314,47096,47119,48255,48622,1526,3.2252610221076212
".Chisago County, Minnesota",56619,56716,57549,57898,58535,1819,3.2127024497076953
".Taliaferro County, Georgia",1559,1559,1569,1608,1609,50,3.207184092366902
".Miami County, Kansas",34193,34224,34641,34791,35320,1096,3.205334425174743
".Broomfield County, Colorado",74105,74490,75411,76195,76860,2370,3.198164766210107
".Charlton County, Georgia",12516,12534,12820,12788,12934,400,3.1959092361776924
".Leelanau County, Michigan",22300,22308,22627,22883,23019,711,3.188340807174888
".Randolph County, Alabama",21961,22086,22184,22460,22786,700,3.1874686945038935
".Greene County, Tennessee",70158,70344,70565,71292,72577,2233,3.182815929758545
".Maricopa County, Arizona",4425102,4445059,4499438,4555833,4585871,140812,3.1821187398618154
".Lincoln County, Oklahoma",33460,33498,33846,34134,34562,1064,3.1799163179916317
".Tarrant County, Texas",2110623,2115840,2129695,2155646,2182947,67107,3.1794877626179567
".Amador County, California",40471,40525,41228,41493,41811,1286,3.177583949000519
".Pearl River County, Mississippi",56153,56211,56480,57183,57978,1767,3.1467597456947978
".Lafayette Parish, Louisiana",241737,242145,244880,247714,249750,7605,3.1459809627818665
".Worcester County, Maryland",52465,52522,53398,53934,54171,1649,3.1430477461164585
".Clark County, Washington",503306,505338,512583,516737,521150,15812,3.1416275585826514
".Rabun County, Georgia",16878,16912,17120,17267,17442,530,3.1401824860765495
".Charles County, Maryland",166621,166741,168927,170111,171973,5232,3.140060376543173
".Cass County, Nebraska",26604,26611,27080,27152,27446,835,3.1386257705608176
".Montrose County, Colorado",42677,42818,43236,43807,44156,1338,3.1351781990299226
".Sanborn County, South Dakota",2331,2326,2373,2403,2399,73,3.131703131703132
".Marshall County, Alabama",97611,97702,98286,99428,100756,3054,3.128745735624059
".Douglas County, Georgia",144310,144648,145748,147453,149160,4512,3.1266024530524565
".Burnett County, Wisconsin",16524,16577,16755,16988,17092,515,3.1166787702735417
".Kalkaska County, Michigan",17941,17931,17994,18244,18490,559,3.115768351819854
".Oconee County, South Carolina",78604,78784,79318,80160,81221,2437,3.100351127169101
".St. Croix County, Wisconsin",93529,93872,94998,95967,96763,2891,3.091019897571876
".Comanche County, Texas",13592,13630,13805,13921,14050,420,3.0900529723366685
".Albany County, Wyoming",37069,37112,37854,38178,38257,1145,3.0888343359680595
".Boone County, Arkansas",37367,37381,37894,38280,38530,1149,3.0749056654267135
".Crow Wing County, Minnesota",66119,66277,67342,67884,68304,2027,3.065684598980626
".Madison County, Idaho",52913,52928,54092,54958,54547,1619,3.059739572505811
".Rowan County, North Carolina",146884,147167,147937,149673,151661,4494,3.0595572016012635
".Anderson County, Kentucky",23863,23883,24084,24273,24613,730,3.0591291958261744
".Chilton County, Alabama",45011,45057,45259,45848,46431,1374,3.052587145364466
".Grundy County, Tennessee",13528,13543,13587,13779,13955,412,3.0455351862803073
".Pike County, Missouri",17581,17400,17596,17644,17935,535,3.0430578465388773
".Harrison County, Texas",68832,68801,69527,70038,70895,2094,3.0421896792189678
".Fulton County, Arkansas",12074,12054,12147,12355,12421,367,3.039589199933742
".Bullitt County, Kentucky",82231,82366,83073,83774,84863,2497,3.0365677177706702
".Santa Cruz County, Arizona",47668,47712,47956,48680,49158,1446,3.033481580934799
".Polk County, Georgia",42851,42924,43316,43669,44223,1299,3.0314345056124714
".Green County, Kentucky",11110,11132,11325,11392,11468,336,3.0243024302430244
".Emery County, Utah",9826,9847,9965,10093,10144,297,3.0225931202931
".Larimer County, Colorado",359074,359923,362747,367577,370771,10848,3.0211042849106313
".Garfield County, Washington",2284,2294,2344,2357,2363,69,3.0210157618213658
".Pacific County, Washington",23368,23495,23993,24095,24200,705,3.016946251283807
".Lubbock County, Texas",310633,311578,314642,317761,320940,9362,3.0138459210708457
".Okaloosa County, Florida",211666,212085,213641,216464,218464,6379,3.0137102794024546
".Rhea County, Tennessee",32873,32938,33189,33689,33924,986,2.9994220180695406
".Cleburne County, Arkansas",24710,24704,25028,25253,25445,741,2.9987859166329423
".Otsego County, New York",58528,58373,60732,60409,60126,1753,2.995147621651175
".Robertson County, Texas",16753,16766,16946,17130,17267,501,2.990509162538053
".Shannon County, Missouri",7026,7028,7090,7216,7238,210,2.9888983774551665
".York County, Maine",211969,212260,215025,216950,218586,6326,2.98439866206851
".Lauderdale County, Alabama",93562,94025,94853,95875,96814,2789,2.980911053632885
".Sully County, South Dakota",1446,1451,1471,1482,1494,43,2.97372060857538
".Madison County, Mississippi",109152,109266,109991,111271,112511,3245,2.972918498973908
".Travis County, Texas",1290218,1296613,1308868,1327550,1334961,38348,2.972210897693258
".Richmond County, Virginia",8919,8919,9077,9126,9184,265,2.9711851104383897
".Missoula County, Montana",117927,118347,119841,121011,121849,3502,2.969633756476464
".Boone County, Kentucky",135988,136468,137747,139045,140496,4028,2.9620260611230402
".Scott County, Minnesota",150916,151347,153611,154423,155814,4467,2.9599247263378303
".Fauquier County, Virginia",72964,73006,74055,74677,75165,2159,2.9589934762348555
".Boone County, Missouri",183604,184047,186115,187721,189463,5416,2.949826801159016
".Fremont County, Colorado",48934,48878,49237,49616,50318,1440,2.942739199738423
".Hidalgo County, Texas",870787,872856,879865,888286,898471,25615,2.9415919162780337
".Elmore County, Alabama",87980,87861,88789,89600,90441,2580,2.932484655603546
".Caribou County, Idaho",7027,7013,7109,7200,7219,206,2.9315497367297567
".Martin County, Florida",158434,158671,160197,161987,163315,4644,2.9311890124594466
".Warrick County, Indiana",63892,63996,64657,65231,65867,1871,2.92837913979841
".Johnson County, Iowa",152862,153056,155035,156915,157528,4472,2.9255145163611624
".Alcona County, Michigan",10169,10192,10295,10397,10489,297,2.920641164322942
".Middlesex County, Virginia",10625,10614,10779,10952,10924,310,2.9176470588235293
".Crawford County, Arkansas",60119,60142,60430,61041,61891,1749,2.909230027112893
".Le Flore County, Oklahoma",48130,48197,48603,49002,49596,1399,2.906710991065863
".Millard County, Utah",12985,13060,13192,13343,13437,377,2.903350019252984
".Dare County, North Carolina",36913,37039,37914,37987,38110,1071,2.9014168450139515
".Chatham County, Georgia",295291,295089,295690,301025,303655,8566,2.9008672800728776
".Newberry County, South Carolina",37721,37731,37968,38315,38825,1094,2.90024124492988
".Pickens County, South Carolina",131408,131684,132097,133470,135495,3811,2.90012784609765
".Camden County, Missouri",42745,42806,43507,43760,44044,1238,2.8962451748742546
".Galveston County, Texas",350684,351590,355560,357387,361744,10154,2.8954842536300487
".Larue County, Kentucky",14861,14873,15027,15150,15303,430,2.893479577417401
".Onslow County, North Carolina",204576,207757,206018,209031,213676,5919,2.893301267010793
".Tyler County, Texas",19798,19810,19898,20411,20382,572,2.8891807253257906
".Clay County, South Dakota",14967,15000,15165,15301,15431,431,2.879668604262711
".Riverside County, California",2418182,2422993,2453399,2474241,2492442,69449,2.87195091188339
".Simpson County, Kentucky",19601,19633,19734,19948,20195,562,2.867200653027907
".Teton County, Montana",6226,6252,6275,6346,6430,178,2.858978477353036
".Baxter County, Arkansas",41628,41686,42224,42485,42875,1189,2.8562506005573174
".Blaine County, Idaho",24278,24348,24782,24901,25041,693,2.854436115001236
".Smith County, Tennessee",19913,19971,20169,20470,20538,567,2.8473861296640384
".Lamar County, Mississippi",64219,64389,65409,65746,66217,1828,2.846509599962628
".Linn County, Kansas",9592,9587,9740,9777,9860,273,2.846121768140117
".Adams County, Pennsylvania",103838,103798,105686,105959,106748,2950,2.840963809010189
".McLennan County, Texas",260588,261193,263721,266162,268583,7390,2.835894208482355
".Albemarle County, Virginia",112395,112510,113882,114845,115676,3166,2.816851283420081
".Logan County, Kentucky",27429,27513,27804,27856,28283,770,2.807247803419738
".Chester County, Pennsylvania",534415,534830,540939,546638,549784,14954,2.798199900826137
".Cherokee County, Alabama",24973,24969,25074,25353,25666,697,2.791014295439074
".Carteret County, North Carolina",67685,67728,68729,69326,69615,1887,2.7879146044175225
".Lexington city, Virginia",7321,7324,7455,7506,7528,204,2.786504575877612
".Stephens County, Oklahoma",42847,42822,43110,43616,44014,1192,2.7819917380446704
".Orange County, Florida",1429908,1431679,1427761,1451761,1471416,39737,2.77898997697754
".Pitt County, North Carolina",170242,170390,172235,173610,175119,4729,2.7778104110619
".Switzerland County, Indiana",9760,9748,9869,10009,10019,271,2.7766393442622954
".Cook County, Georgia",17232,17236,17262,17409,17714,478,2.7739090064995358
".Powder River County, Montana",1697,1696,1710,1732,1743,47,2.769593400117855
".Perquimans County, North Carolina",13008,13018,13117,13221,13377,359,2.759840098400984
".Powell County, Montana",6945,6942,7025,7078,7133,191,2.750179985601152
".Stephens County, Texas",9098,9093,9433,9377,9343,250,2.747856671795999
".Peach County, Georgia",27986,28036,28245,28486,28805,769,2.747802472664904
".Jones County, North Carolina",9174,9149,9210,9219,9401,252,2.746893394375409
".Cheatham County, Tennessee",41064,41131,41498,41764,42254,1123,2.7347555036041302
".Otoe County, Nebraska",15910,15901,16017,16186,16335,434,2.7278441231929604
".Clark County, Nevada",2265475,2274887,2295310,2322535,2336573,61686,2.722872686743398
".Seminole County, Florida",470857,471455,470857,478623,484271,12816,2.72184548599681
".Lynn County, Texas",5593,5609,5645,5738,5761,152,2.717682817807974
".Westmoreland County, Virginia",18479,18511,18772,18765,19013,502,2.716597218464203
".Colorado County, Texas",20558,20563,20642,20832,21117,554,2.69481467068781
".Calaveras County, California",45284,45348,46249,46556,46565,1217,2.6874834378588464
".Deer Lodge County, Montana",9424,9420,9518,9544,9673,253,2.684634974533107
".McDonald County, Missouri",23301,23280,23429,23593,23903,623,2.6737049912020945
".Sublette County, Wyoming",8726,8736,8722,8752,8969,233,2.670181068072427
".Polk County, Tennessee",17544,17566,17714,17778,18033,467,2.6618787049703605
".Palm Beach County, Florida",1492199,1494282,1503435,1519867,1533801,39519,2.6483733067774473
".San Patricio County, Texas",68754,68841,69767,70087,70660,1819,2.6456642522616867
".Shelby County, Kentucky",48101,48244,48588,48842,49515,1271,2.6423567077607535
".Gooding County, Idaho",15601,15649,15793,15879,16061,412,2.640856355361836
".Sequoyah County, Oklahoma",39289,39257,39494,39801,40291,1034,2.631779887500318
".Columbia County, Washington",3952,3949,4016,4026,4053,104,2.631578947368421
".Gwinnett County, Georgia",957306,958359,965338,976173,983526,25167,2.6289399627705246
".Benton County, Oregon",95183,95214,96321,97661,97713,2499,2.625468833720307
".Grand Isle County, Vermont",7291,7276,7428,7490,7467,191,2.6196680839391027
".San Joaquin County, California",779230,780617,788354,794293,800965,20348,2.6112957663334315
".Stone County, Arkansas",12354,12349,12441,12585,12671,322,2.6064432572446172
".Davis County, Utah",362695,363771,367504,369887,373207,9436,2.601634982561105
".Hamblen County, Tennessee",64500,64542,64360,65167,66216,1674,2.5953488372093023
".Fergus County, Montana",11447,11475,11622,11672,11772,297,2.594566261902682
".Walker County, Georgia",67653,67738,68417,68965,69489,1751,2.5882074704743325
".Warren County, Virginia",40721,40792,40965,41404,41843,1051,2.5809778738243168
".Irion County, Texas",1512,1510,1534,1534,1549,39,2.579365079365079
".Tuscaloosa County, Alabama",227037,231547,235670,236690,237373,5826,2.566101560538591
".Florence County, Wisconsin",4560,4565,4593,4706,4682,117,2.5657894736842106
".Murray County, Georgia",39976,40012,39975,40410,41035,1023,2.5590354212527515
".Pickett County, Tennessee",5004,5000,5069,5103,5128,128,2.5579536370903275
".Lonoke County, Arkansas",74012,74055,74770,75199,75944,1889,2.552288818029509
".Atoka County, Oklahoma",14145,14165,14294,14327,14525,360,2.545068928950159
".Rockdale County, Georgia",93513,93611,93888,94945,95987,2376,2.54082320105226
".Forsyth County, North Carolina",382599,383202,386376,389661,392921,9719,2.5402575542539316
".Bradley County, Tennessee",108620,108828,109755,110539,111579,2751,2.532682747192046
".Sweet Grass County, Montana",3677,3670,3702,3727,3763,93,2.5292357900462337
".St. Charles County, Missouri",405271,406417,410465,413798,416659,10242,2.527197850327312
".Morgan County, Tennessee",21030,21042,21107,21207,21573,531,2.5249643366619114
".Gentry County, Missouri",6162,6132,6184,6274,6287,155,2.515417072379098
".Benzie County, Michigan",17964,17990,18237,18327,18441,451,2.5105767089735025
".Craig County, Oklahoma",14106,14141,14201,14176,14494,353,2.502481213667943
".Montezuma County, Colorado",25849,25887,26234,26467,26531,644,2.4913923169174823
".Polk County, Iowa",492410,493022,497842,501184,505255,12233,2.4843118539428524
".Adams County, Colorado",519578,520500,523544,527509,533365,12865,2.4760478696172665
".Licking County, Ohio",178513,178784,180021,181765,183201,4417,2.4743296006453313
".Bedford County, Virginia",79465,79559,80242,80741,81525,1966,2.474045177122003
".Clark County, South Dakota",3841,3853,3873,3923,3948,95,2.473314241083051
".Sullivan County, Tennessee",158162,158246,159212,160862,162135,3889,2.458871283873497
".McCook County, South Dakota",5679,5670,5718,5768,5809,139,2.44761401655221
".Cumberland County, Kentucky",5884,5856,5900,5969,6000,144,2.4473147518694764
".Otsego County, Michigan",25089,25133,25324,25561,25747,614,2.4472876559448364
".Haskell County, Oklahoma",11558,11550,11615,11667,11832,282,2.4398684893580205
".Edmonson County, Kentucky",12132,12152,12237,12302,12448,296,2.4398285525881964
".Williamsburg city, Virginia",15413,15471,15609,15685,15847,376,2.439499124116006
".Waldo County, Maine",39596,39658,39978,40255,40620,962,2.4295383372057784
".Autauga County, Alabama",58809,58915,59203,59726,60342,1427,2.4264993453382986
".Grant County, Kentucky",24945,25015,25292,25474,25619,604,2.421326919222289
".Aitkin County, Minnesota",15706,15722,15957,16142,16102,380,2.419457532153317
".Stanley County, South Dakota",2981,2971,3035,3017,3043,72,2.41529688024153
".Wabaunsee County, Kansas",6876,6891,6970,7009,7057,166,2.414194299011053
".Sawyer County, Wisconsin",18073,18118,18226,18521,18552,434,2.401372212692967
".Yancey County, North Carolina",18474,18496,18764,18768,18938,442,2.3925516942730325
".Putnam County, Indiana",36734,36689,37043,37294,37567,878,2.3901562585071052
".Hampshire County, West Virginia",23094,23101,23360,23457,23649,548,2.3729107127392397
".Lincoln County, Tennessee",35320,35331,35435,36006,36169,838,2.372593431483579
".Quitman County, Georgia",2237,2227,2242,2259,2280,53,2.3692445239159587
".Taylor County, Texas",143203,143454,143922,145147,146836,3382,2.3616823669895184
".Franklin city, Virginia",8176,8146,8152,8274,8339,193,2.3605675146771037
".Mesa County, Colorado",155706,156011,157439,158531,159681,3670,2.3570061526209654
".Howell County, Missouri",39749,39799,40016,40623,40735,936,2.3547762207854284
".Campbell County, Tennessee",39275,39301,39455,39564,40223,922,2.347549331635901
".Berrien County, Georgia",18159,18144,18117,18215,18570,426,2.3459441599207005
".Doña Ana County, New Mexico",219569,220060,221732,223530,225210,5150,2.345504146760244
".Catawba County, North Carolina",160597,160888,161675,163167,164645,3757,2.3393961281966664
".Glasscock County, Texas",1113,1115,1136,1139,1141,26,2.336028751123091
".Androscoggin County, Maine",111132,111175,112732,113225,113765,2590,2.3305618543713784
".Kerr County, Texas",52591,52693,53175,53784,53915,1222,2.3235914890380482
".Henry County, Missouri",21945,21976,22208,22421,22485,509,2.319434951013898
".Cherokee County, Oklahoma",47080,47096,47659,48074,48185,1089,2.3130841121495327
".Lincoln County, Georgia",7689,7702,7749,7859,7879,177,2.3019898556379244
".Buncombe County, North Carolina",269431,269702,271945,273790,275901,6199,2.3007745953509433
".Stone County, Mississippi",18336,18335,18578,18641,18756,421,2.2960296684118675
".Lawrence County, Missouri",38011,38000,38268,38689,38872,872,2.2940727684091446
".Copper River Census Area, Alaska",2616,2614,2621,2609,2674,60,2.293577981651376
".Mills County, Texas",4453,4446,4489,4498,4548,102,2.2905906130698406
".Menifee County, Kentucky",6114,6146,6185,6236,6286,140,2.289826627412496
".Henderson County, North Carolina",116310,116574,117155,118298,119230,2656,2.283552575015046
".Pulaski County, Georgia",9854,9870,9570,9963,10095,225,2.2833367160543943
".Graham County, Arizona",38541,38646,38921,38822,39525,879,2.2806880983887288
".Montcalm County, Michigan",66604,66635,67320,67209,68154,1519,2.2806438051768665
".Richland County, South Carolina",416147,415671,417294,421526,425138,9467,2.2749172768276593
".Dane County, Wisconsin",561508,562615,561542,567758,575347,12732,2.26746546798977
".Navajo County, Arizona",106714,106763,107726,108800,109175,2412,2.260247015386922
".Fleming County, Kentucky",15087,15101,15265,15278,15442,341,2.2602240339365016
".Hart County, Kentucky",19281,19290,19477,19594,19724,434,2.2509205954048026
".Alachua County, Florida",278474,279737,281889,284041,285994,6257,2.246888398916955
".Butler County, Pennsylvania",193774,194077,196759,197368,198413,4336,2.2376583029715027
".Beadle County, South Dakota",19151,19165,19181,19488,19591,426,2.22442692287609
".Clay County, Missouri",253329,254137,255871,256930,259772,5635,2.2243801538710533
".Douglas County, Minnesota",38996,39087,39298,39684,39953,866,2.2207405887783365
".Orange County, Vermont",29283,29295,29630,29880,29943,648,2.212888023768057
".Delta County, Colorado",31201,31056,31392,31560,31746,690,2.21146758116727
".Columbia County, Oregon",52593,52724,53202,53607,53880,1156,2.198011142167209
".Cumberland County, Maine",303065,303585,306107,308837,310230,6645,2.19259894742052
".Gunnison County, Colorado",16921,16950,17294,17320,17321,371,2.1925418119496483
".Cumberland County, Virginia",9676,9666,9703,9751,9878,212,2.190988011575031
".Allen County, Indiana",385394,386103,389163,391644,394545,8442,2.190485580989844
".Codington County, South Dakota",28321,28351,28484,28736,28971,620,2.1891882348787117
".Ottawa County, Michigan",296203,296907,298393,300918,303372,6465,2.182624753969406
".Anoka County, Minnesota",363904,364499,367802,369108,372441,7942,2.182443721421034
".Shenandoah County, Virginia",44190,44265,44842,44936,45228,963,2.1792260692464356
".Deuel County, Nebraska",1837,1831,1847,1901,1871,40,2.1774632553075666
".Roberts County, Texas",828,822,801,812,840,18,2.1739130434782608
".Van Buren County, Arkansas",15795,15799,15777,16103,16142,343,2.1715732826843936
".Bartholomew County, Indiana",82211,82218,82729,83394,84003,1785,2.1712422911775797
".Sabine County, Texas",9896,9892,10013,10041,10106,214,2.1624898949070332
".Stokes County, North Carolina",44524,44572,44625,45136,45532,960,2.1561405084898033
".Presque Isle County, Michigan",12988,13005,13172,13343,13285,280,2.15583615645211
".Le Sueur County, Minnesota",28667,28637,28900,29124,29255,618,2.1557888861757424
".Montgomery County, Georgia",8610,8576,8646,8643,8761,185,2.148664343786295
".Lincoln County, Kentucky",24281,24255,24295,24419,24776,521,2.1457106379473663
".Johnson County, Tennessee",17949,17990,18053,18046,18375,385,2.144966293386818
".Martinsville city, Virginia",13480,13474,13534,13697,13763,289,2.1439169139465872
".Carroll County, Maryland",172895,172941,174313,175472,176639,3698,2.1388704126782154
".Grafton County, New Hampshire",91122,91198,90495,93131,93146,1948,2.1377932881192248
".Pasquotank County, North Carolina",40567,40577,40807,41168,41444,867,2.1372051174600046
".Craighead County, Arkansas",111242,111619,111794,112863,113993,2374,2.1340860466370617
".Sagadahoc County, Maine",36703,36732,37170,37372,37513,781,2.12789145301474
".Mayes County, Oklahoma",39050,39059,39259,39570,39889,830,2.1254801536491676
".Beaver County, Utah",7069,7083,7213,7317,7233,150,2.1219408685811287
".Harris County, Texas",4731122,4734792,4735517,4781337,4835125,100333,2.120702023748278
".Washoe County, Nevada",486493,487710,494300,496980,498022,10312,2.119660508989852
".Polk County, Oregon",87431,87956,89373,89593,89805,1849,2.114810536308632
".Jackson County, Mississippi",143245,143373,144459,144963,146389,3016,2.1054836119934377
".Randolph County, North Carolina",144147,144425,145154,146196,147458,3033,2.104102062477887
".Coryell County, Texas",83085,83130,84389,84205,84878,1748,2.103869531202985
".Blaine County, Nebraska",428,427,462,452,436,9,2.102803738317757
".DeKalb County, Indiana",43260,43292,43395,43813,44198,906,2.0943134535367545
".Sullivan County, New Hampshire",43058,43068,43605,43918,43969,901,2.092526359793766
".Barry County, Missouri",34533,34544,34762,34944,35265,721,2.0878579909072483
".Madison County, Texas",13462,13461,13512,13641,13742,281,2.0873570049026893
".Payne County, Oklahoma",81647,81648,82163,82701,83352,1704,2.087033203914412
".Washington County, Oklahoma",52455,52615,52903,53238,53706,1091,2.0798779906586597
".Creek County, Oklahoma",71752,71841,72224,72686,73332,1491,2.0779908573977033
".Live Oak County, Texas",11333,11349,11386,11541,11584,235,2.073590399717639
".Rankin County, Mississippi",157025,157162,158123,158978,160417,3255,2.0729183251074668
".White County, Arkansas",76824,76860,77109,77616,78452,1592,2.072269082578361
".Trigg County, Kentucky",14053,14078,14220,14348,14369,291,2.070732227994023
".Craven County, North Carolina",100722,100307,100396,101087,102391,2084,2.0690613768590773
".Parke County, Indiana",16147,16150,16486,16367,16484,334,2.068495695794885
".Madison County, Iowa",16546,16629,16793,17040,16971,342,2.0669648253354285
".Penobscot County, Maine",152187,152169,153359,154728,155312,3143,2.0652223908743848
".San Saba County, Texas",5724,5727,5829,5880,5845,118,2.0614954577218727
".Baraga County, Michigan",8152,8142,8286,8283,8310,168,2.060843964671246
".Kittitas County, Washington",44310,44599,44645,45122,45508,909,2.051455653351388
".Fannin County, Georgia",25321,25436,25797,25733,25955,519,2.049682082066269
".Kennebec County, Maine",124503,124712,125752,126535,127259,2547,2.0457338377388496
".Nelson County, Kentucky",46727,46779,47127,47359,47730,951,2.0352258865324115
".Grant County, Arkansas",17960,18018,18123,18129,18383,365,2.032293986636971
".Bath County, Kentucky",12747,12716,12795,12828,12975,259,2.0318506315211424
".Carroll County, Arkansas",28257,28240,28539,28717,28814,574,2.031355062462399
".Troup County, Georgia",69426,69333,69518,70247,70742,1409,2.0294990349436812
".Grundy County, Illinois",52539,52516,52959,53149,53578,1062,2.021355564437846
".Adair County, Kentucky",18904,18883,18966,19097,19264,381,2.0154464663563267
".Northampton County, Pennsylvania",312949,312784,318157,317900,319091,6307,2.0153443532332744
".Coleman County, Texas",7687,7688,7722,7822,7842,154,2.003382333810329
".Ozaukee County, Wisconsin",91509,91629,92600,93021,93460,1831,2.00089608672371
".Nez Perce County, Idaho",42091,42145,42500,42909,42987,842,2.000427644864698
".Glynn County, Georgia",84500,84482,84786,85145,86172,1690,2.0
".Jones County, Georgia",28353,28402,28406,28512,28969,567,1.9997883821817795
".King and Queen County, Virginia",6606,6588,6669,6714,6720,132,1.9981834695731153
".Kingfisher County, Oklahoma",15190,15178,15223,15228,15481,303,1.9947333772218565
".Newaygo County, Michigan",49982,50111,50413,50728,51108,997,1.9947180985154653
".Merrimack County, New Hampshire",153805,154038,154622,156459,157103,3065,1.9927830694710835
".Lamar County, Texas",50081,50131,50349,50515,51127,996,1.9887781793494537
".Manistee County, Michigan",25030,25066,25328,25365,25562,496,1.981622053535757
".Brantley County, Georgia",18021,18044,18119,18210,18401,357,1.9810221408356916
".Jefferson County, Washington",32971,33061,33553,33570,33714,653,1.9805283430893816
".Pawnee County, Oklahoma",15555,15557,15707,15681,15864,307,1.9736419157827065
".Whatcom County, Washington",226852,227449,226701,230598,231919,4470,1.9704476927688535
".Lafayette County, Wisconsin",16611,16618,16830,16906,16945,327,1.9685750406357234
".Yolo County, California",216409,216291,213141,222018,220544,4253,1.9652602248520163
".Belknap County, New Hampshire",63707,63776,64599,64705,65027,1251,1.9636774608755707
".Sibley County, Minnesota",14825,14793,14923,14928,15084,291,1.962900505902192
".Lee County, Georgia",33164,33222,33209,33678,33872,650,1.9599565794234712
".Franklin County, Virginia",54467,54482,55017,55079,55549,1067,1.9589843391411312
".Linn County, Oregon",128611,128981,130120,130622,131496,2515,1.9555092488200854
".Calvert County, Maryland",92789,92915,94233,94559,94728,1813,1.953895397083706
".Mercer County, Kentucky",22644,22655,22860,22900,23097,442,1.951951951951952
".Decatur County, Tennessee",11436,11433,11402,11549,11656,223,1.9499825113676112
".Guilford County, North Carolina",541297,539321,542495,546457,549866,10545,1.9480987332277842
".Franklin County, Washington",96748,97150,98102,98582,99034,1884,1.9473270765287136
".Carter County, Missouri",5200,5202,5321,5254,5303,101,1.942307692307692
".Lowndes County, Georgia",118247,118416,118916,119499,120712,2296,1.9416983094708535
".Gloucester County, New Jersey",302273,302563,304592,306767,308423,5860,1.9386448673880896
".Barry County, Michigan",62421,62598,63141,63402,63808,1210,1.9384502010541322
".Morgan County, Indiana",71776,71836,72275,72260,73227,1391,1.9379736959429337
".Rockingham County, New Hampshire",314180,314621,318260,319633,320689,6068,1.9313769176904958
".Madison County, Virginia",13841,13861,13957,14008,14128,267,1.929051369120728
".Nicholas County, Kentucky",7532,7541,7733,7786,7686,145,1.9251194901752522
".Prairie County, Montana",1091,1091,1097,1108,1112,21,1.924839596700275
".Franklin County, Arkansas",17103,17139,17166,17270,17468,329,1.9236391276384261
".Greene County, Arkansas",45738,45864,46341,46408,46743,879,1.9218155581791945
".Falls County, Texas",16968,16960,17113,16956,17286,326,1.9212635549269212
".Union County, South Dakota",16818,16860,16876,17063,17183,323,1.9205613033654418
".Spokane County, Washington",539340,541175,545510,549740,551455,10280,1.9060332999592093
".Glascock County, Georgia",2887,2899,2901,2928,2954,55,1.9050917907862834
".Childress County, Texas",6668,6661,6787,6841,6788,127,1.9046190761847632
".Jasper County, Indiana",32926,32908,33165,33345,33535,627,1.904270181619389
".Marshall County, South Dakota",4310,4308,4324,4363,4390,82,1.9025522041763343
".Franklin County, Vermont",49951,50046,50430,50719,50994,948,1.8978599027046505
".Eau Claire County, Wisconsin",105713,105897,106017,106786,107903,2006,1.8975906463727261
".Grays Harbor County, Washington",75634,75855,76838,77041,77290,1435,1.8972948673876828
".Stillwater County, Montana",8964,9003,9024,9169,9173,170,1.896474788041053
".Leavenworth County, Kansas",81901,81966,82398,82922,83518,1552,1.8949707573778098
".Jefferson County, Missouri",226569,226937,227993,229220,231230,4293,1.8947870185241582
".Washburn County, Wisconsin",16623,16616,16748,16871,16930,314,1.8889490465018348
".Pierce County, Wisconsin",42206,42229,41606,42552,43026,797,1.8883571056247928
".Metcalfe County, Kentucky",10290,10288,10391,10408,10482,194,1.8853255587949467
".Gladwin County, Michigan",25387,25378,25475,25621,25853,475,1.871036357190688
".Upson County, Georgia",27700,27745,27689,28093,28263,518,1.8700361010830324
".Perry County, Arkansas",10018,9997,9995,10073,10184,187,1.8666400479137553
".Pope County, Arkansas",63384,63410,63778,64053,64593,1183,1.8664016155496657
".Sullivan County, New York",78613,78453,79702,79735,79920,1467,1.8661035706562528
".Washington County, Kentucky",12029,12043,12080,12060,12267,224,1.8621664311247819
".Holmes County, Florida",19659,19578,19309,19653,19944,366,1.8617427132611017
".Granville County, North Carolina",61003,61061,61365,61702,62192,1131,1.8540071799747555
".Colbert County, Alabama",57232,57304,57644,57993,58361,1057,1.8468688845401173
".Butler County, Kansas",67376,67391,67976,68289,68632,1241,1.8419021610068869
".Osceola County, Michigan",22892,22909,23196,23279,23330,421,1.8390704176131398
".Wayne County, Nebraska",9699,9696,9864,9899,9874,178,1.8352407464687082
".Laurens County, South Carolina",67537,67634,67835,67951,68873,1239,1.8345499503975597
".Hancock County, Maine",55482,55511,56355,56549,56526,1015,1.8294221549331315
".Greeley County, Nebraska",2189,2179,2181,2235,2219,40,1.827318410232983
".Gilpin County, Colorado",5806,5820,5893,5886,5926,106,1.8256975542542198
".Calloway County, Kentucky",37544,37596,37896,38093,38280,684,1.8218623481781375
".Johnson County, Kansas",609877,611149,614889,619091,622237,11088,1.8180715127804459
".Tulsa County, Oklahoma",669277,670702,674051,677061,682868,12166,1.8177824727280336
".Claiborne County, Tennessee",32041,32072,32061,32357,32654,582,1.816422708404856
".Moody County, South Dakota",6332,6335,6305,6382,6450,115,1.8161718256475046
".Briscoe County, Texas",1434,1419,1400,1439,1445,26,1.813110181311018
".Cecil County, Maryland",103724,103800,104056,104870,105672,1872,1.8047896340287688
".Dent County, Missouri",14416,14387,14454,14488,14647,260,1.8035516093229744
".Ashe County, North Carolina",26582,26584,26757,27062,27063,479,1.8019712587465202
".Cheboygan County, Michigan",25586,25587,25754,25964,26048,461,1.8017665911045102
".York County, Nebraska",14126,14102,14239,14312,14356,254,1.7981027891830668
".Madison County, Indiana",130121,130167,130841,131383,132504,2337,1.796020626954911
".Oconto County, Wisconsin",38965,39077,39421,39696,39775,698,1.7913512126267164
".Chesterfield County, South Carolina",43272,43256,43337,43741,44031,775,1.7909964873359214
".Snohomish County, Washington",827953,829933,836097,840452,844761,14828,1.7909229147065113
".Marion County, Tennessee",28838,28870,28919,29050,29382,512,1.775435189680283
".Duplin County, North Carolina",48703,48658,48558,48934,49520,862,1.7699115044247788
".Carlton County, Minnesota",36191,36185,36440,36544,36825,640,1.7683954574341687
".Laclede County, Missouri",36037,36043,36156,36345,36680,637,1.767627715958598
".Greene County, Missouri",298913,299328,301098,303197,304611,5283,1.7674038934405663
".Goliad County, Texas",7016,7020,7133,7120,7144,124,1.767388825541619
".Miami County, Ohio",108775,108959,109411,110213,110876,1917,1.7623534819581703
".Cooper County, Missouri",17103,16646,16676,16763,16947,301,1.7599251593287728
".Morrow County, Ohio",34945,34980,35205,35336,35595,615,1.759908427528974
".Elbert County, Georgia",19638,19668,19571,19873,20013,345,1.7567980446073939
".Ontonagon County, Michigan",5813,5804,5870,5921,5906,102,1.754687768794082
".Karnes County, Texas",14707,14760,14732,14945,15018,258,1.7542666757326444
".Henry County, Kentucky",15681,15698,15708,15760,15973,275,1.7537146865633568
".Jackson County, Alabama",52579,52545,52719,52923,53467,922,1.7535517982464481
".Jasper County, Missouri",122770,122907,123324,124016,125056,2149,1.7504276288995684
".Brown County, Texas",38092,38043,38135,38443,38709,666,1.74839861388218
".Dade County, Missouri",7568,7584,7596,7665,7716,132,1.744186046511628
".Morton County, North Dakota",33287,33315,33565,33705,33895,580,1.7424219665334817
".Trimble County, Kentucky",8468,8460,8549,8527,8607,147,1.735947094945678
".York County, Pennsylvania",456441,456720,459183,461049,464640,7920,1.7351640190079332
".Edmunds County, South Dakota",3987,3988,4034,4071,4057,69,1.7306245297215952
".Pima County, Arizona",1043435,1045175,1048914,1057476,1063162,17987,1.7238256336043933
".Johnson County, Missouri",54010,54031,54194,54449,54962,931,1.7237548602110722
".Green Lake County, Wisconsin",19016,19017,19249,19208,19344,327,1.7196045435422802
".Madison County, Ohio",43843,43849,44428,43581,44602,753,1.7174919599479963
".Treasure County, Montana",760,759,768,754,772,13,1.710526315789474
".Aurora County, South Dakota",2748,2735,2736,2762,2782,47,1.710334788937409
".Monongalia County, West Virginia",105821,105912,106521,106978,107718,1806,1.7066555787603594
".Taylor County, Kentucky",26020,26000,26187,26396,26443,443,1.7025365103766332
".Pottawatomie County, Oklahoma",72458,72559,73045,73351,73791,1232,1.7002953435093435
".Forest County, Wisconsin",9179,9169,9257,9332,9325,156,1.699531539383375
".Golden Valley County, Montana",824,821,815,826,835,14,1.6990291262135921
".Gray County, Kansas",5655,5647,5664,5711,5743,96,1.6976127320954906
".Alamosa County, Colorado",16380,16377,16579,16587,16655,278,1.6971916971916972
".Lower Connecticut River Valley Planning Region, Connecticut",174225,173268,175430,175982,176215,2947,1.6914908882192567
".Storey County, Nevada",4100,4108,4142,4165,4177,69,1.6829268292682928
".Montgomery County, Indiana",37930,37935,38057,38319,38573,638,1.6820458739783815
".Todd County, Kentucky",12248,12288,12301,12394,12494,206,1.6819072501632921
".Randolph County, Arkansas",18574,18595,18839,18852,18907,312,1.6797674168192098
".Cleveland County, Oklahoma",295525,296236,298110,299484,301193,4957,1.6773538617714239
".Conway County, Arkansas",20710,20730,20902,21021,21077,347,1.6755190729116367
".Cowlitz County, Washington",110728,111014,111685,112064,112864,1850,1.6707607831804059
".Roscommon County, Michigan",23455,23472,23653,23682,23863,391,1.667021956938819
".Union County, Mississippi",27791,27822,28033,28132,28284,462,1.6624086934619122
".Clay County, Tennessee",7580,7588,7586,7656,7714,126,1.6622691292875988
".Hardee County, Florida",25330,25339,25322,25651,25760,421,1.662060797473352
".Strafford County, New Hampshire",130895,131068,131534,132571,133243,2175,1.6616371901142137
".Bristol Bay Borough, Alaska",843,830,842,870,844,14,1.6607354685646498
".Pulaski County, Kentucky",65039,65116,65571,65767,66191,1075,1.652854441181445
".Chesapeake city, Virginia",249369,249781,251763,252459,253886,4105,1.646154894954866
".Somerset County, Maine",50481,50473,50782,51118,51302,829,1.642202016600305
".Missaukee County, Michigan",15055,15065,15173,15232,15311,246,1.6340086350049816
".Dickinson County, Iowa",17703,17767,17868,18048,18056,289,1.6324916680788566
".Barnstable County, Massachusetts",228995,228012,232315,232078,231735,3723,1.6257996899495621
".Phelps County, Missouri",44636,44559,44899,45273,45284,725,1.6242494847208533
".Mills County, Iowa",14483,14398,14467,14535,14633,235,1.622592004418974
".Burlington County, New Jersey",461869,461682,464479,466101,469167,7485,1.6205893879000324
".El Paso County, Colorado",730405,732384,737287,740596,744215,11831,1.6197862829526084
".Dinwiddie County, Virginia",27941,27891,27997,28099,28343,452,1.6176944275437528
".Orange County, New York",401315,400986,405167,406491,407470,6484,1.615688424305097
".Polk County, Wisconsin",44982,45039,45466,45546,45762,723,1.607309590502868
".Amelia County, Virginia",13260,13267,13306,13368,13480,213,1.6063348416289591
".Gregg County, Texas",124238,124251,124130,125559,126243,1992,1.6033741689338206
".Clinton County, Missouri",21176,21209,21213,21303,21548,339,1.60086890819796
".Tipton County, Tennessee",60974,61042,61059,61650,62015,973,1.5957621281201824
".Dakota County, Minnesota",439878,440423,442730,443272,447440,7017,1.5952150368965938
".Montgomery County, Arkansas",8482,8485,8635,8543,8620,135,1.5916057533600567
".Marquette County, Wisconsin",15591,15590,15784,15777,15838,248,1.59066127894298
".Hardin County, Tennessee",26824,26804,26871,27065,27229,425,1.5844020280345958
".Rutherford County, North Carolina",64446,64486,64616,64945,65507,1021,1.5842721037768053
".Rusk County, Texas",52215,52252,52695,52524,53079,827,1.5838360624341665
".Coke County, Texas",3285,3300,3304,3322,3352,52,1.5829528158295283
".Uvalde County, Texas",24575,24571,24803,24890,24960,389,1.582909460834181
".Warren County, New Jersey",109637,109520,110567,110903,111252,1732,1.5797586581172414
".Stearns County, Minnesota",158296,158480,159204,160242,160977,2497,1.5774245716884825
".Osage County, Missouri",13275,13259,13398,13398,13468,209,1.5743879472693032
".Montgomery County, Missouri",11312,11281,11433,11479,11459,178,1.5735502121640734
".Johnson County, Arkansas",25749,25724,25957,25970,26129,405,1.5728766165676336
".Cleveland County, North Carolina",99526,99817,100341,100653,101378,1561,1.5684343789562527
".Noble County, Ohio",14110,14090,14309,14325,14311,221,1.566265060240964
".Waushara County, Wisconsin",24524,24550,24760,24927,24934,384,1.5658130810634479
".Saluda County, South Carolina",18855,18828,18822,18984,19123,295,1.5645717316361707
".Benton County, Tennessee",15867,15855,15837,15994,16103,248,1.5629923741097875
".Fremont County, Wyoming",39235,39202,39416,39566,39815,613,1.5623805275901619
".Ottawa County, Kansas",5729,5729,5830,5806,5818,89,1.5534997381742015
".Floyd County, Georgia",98582,98583,98487,99437,100113,1530,1.5520074658659795
".Clermont County, Ohio",208595,208750,209893,210679,211972,3222,1.544619957333589
".Dallam County, Texas",7123,7127,7175,7235,7237,110,1.544293134915064
".Vernon County, Wisconsin",30711,30696,30917,31063,31170,474,1.543420924098857
".Northeastern Connecticut Planning Region, Connecticut",95336,95222,95605,96148,96692,1470,1.5419149114710078
".Russell County, Kentucky",17996,18002,18172,18185,18279,277,1.5392309402089352
".Morgan County, Colorado",29108,29076,29006,29266,29524,448,1.5390957812285282
".Young County, Texas",17868,17849,17943,18012,18124,275,1.5390642489366466
".Sussex County, New Jersey",144220,143915,145721,145575,146132,2217,1.5372347801969213
".Clare County, Michigan",30863,30843,31131,31307,31316,473,1.5325794640832064
".Stephens County, Georgia",26779,26818,26765,26746,27228,410,1.5310504499794615
".Eastland County, Texas",17723,17766,17826,17893,18037,271,1.5290864977712577
".Meriwether County, Georgia",20620,20617,20725,20890,20931,314,1.5227934044616875
".Essex County, Vermont",5920,5920,5970,5997,6010,90,1.5202702702702704
".Naugatuck Valley Planning Region, Connecticut",450435,449285,452281,453590,456128,6843,1.5191981084951214
".Transylvania County, North Carolina",32984,33048,33272,33373,33549,501,1.5189182634004366
".Cheshire County, New Hampshire",76454,76547,76846,77463,77703,1156,1.5120202997881078
".Caldwell County, Missouri",8812,8822,8904,8939,8955,133,1.5093054925102134
".Panola County, Texas",22496,22499,22556,22742,22838,339,1.5069345661450926
".Washington County, Maine",31090,31088,31192,31527,31555,467,1.5020907044065617
".Carroll County, Kentucky",10798,10825,10896,10939,10987,162,1.5002778292276346
".Carroll County, Tennessee",28444,28434,28295,28418,28860,426,1.4976796512445507
".Marquette County, Michigan",66013,66012,65739,66548,66999,987,1.4951600442337116
".Morgan County, Alabama",123424,123288,123375,124231,125133,1845,1.4948470313715323
".Jackson County, Texas",14990,14997,15118,15183,15221,224,1.4943295530353569
".Lucas County, Iowa",8633,8618,8706,8702,8747,129,1.494266187883702
".Douglas County, Kansas",118779,118784,119493,120007,120553,1769,1.4893205027824783
".Kingsbury County, South Dakota",5180,5199,5201,5279,5276,77,1.4864864864864866
".Carson County, Texas",5799,5792,5714,5816,5878,86,1.483014312812554
".Lake County, Oregon",8163,8172,8290,8373,8293,121,1.4822981746906776
".Door County, Wisconsin",30065,30117,30425,30551,30562,445,1.4801263928155661
".Garfield County, Colorado",61686,61794,62107,62256,62707,913,1.4800765165515677
".Montgomery County, Kentucky",28109,28112,28230,28357,28527,415,1.4763954605286562
".Todd County, Minnesota",25266,25294,25288,25533,25667,373,1.4762922504551572
".Franklin County, Missouri",104689,104864,105307,105793,106404,1540,1.4710236987649132
".Nash County, North Carolina",94967,95157,95204,95820,96551,1394,1.4678783156254278
".Hamilton County, Nebraska",9424,9400,9384,9439,9537,137,1.4537351443123938
".Nantucket County, Massachusetts",14251,14237,14506,14443,14444,207,1.4525296470423128
".Rockingham County, North Carolina",91104,91195,91211,91966,92518,1323,1.4521865121180189
".Iron County, Wisconsin",6131,6139,6172,6199,6228,89,1.4516392105692384
".Fountain County, Indiana",16480,16492,16480,16620,16731,239,1.4502427184466018
".Livingston County, Michigan",193861,193968,195333,196134,196757,2789,1.4386596582087166
".Daviess County, Missouri",8432,8430,8400,8457,8551,121,1.4350094876660342
".Botetourt County, Virginia",33595,33643,33998,34100,34125,482,1.4347373121000149
".Crawford County, Georgia",12128,12103,12139,12169,12277,174,1.4346965699208443
".Otero County, New Mexico",67835,67862,68486,68517,68835,973,1.434362792068991
".Burleigh County, North Dakota",98464,98601,98965,99396,100012,1411,1.433011049723757
".Cape Girardeau County, Missouri",81710,81821,82132,82931,82984,1163,1.4233263982376698
".Wells County, Indiana",28169,28155,28154,28298,28555,400,1.4200007100003549
".Logan County, Arkansas",21128,21100,21229,21258,21400,300,1.419916698220371
".Somerset County, Maryland",24615,24561,24546,24608,24910,349,1.4178346536664637
".Caledonia County, Vermont",30232,30182,30457,30587,30610,428,1.415718444032813
".Prince William County, Virginia",482200,482834,485352,487012,489640,6806,1.4114475321443383
".Lorain County, Ohio",312956,313498,314216,316031,317910,4412,1.4097828448727618
".Uinta County, Wyoming",20445,20457,20681,20727,20745,288,1.408657373440939
".Person County, North Carolina",39088,39187,39148,39343,39737,550,1.4070814572247237
".Clay County, Minnesota",65316,65344,65651,65860,66258,914,1.399350848184212
".Yadkin County, North Carolina",37216,37254,37276,37507,37774,520,1.3972484952708513
".Holt County, Missouri",4231,4189,4232,4254,4248,59,1.3944693925785865
".St. Bernard Parish, Louisiana",43765,43856,44324,44419,44463,607,1.3869530446703988
".Steuben County, Indiana",34439,34441,34702,34772,34917,476,1.3821539533668226
".Grayson County, Kentucky",26421,26460,26583,26643,26825,365,1.3814768555315846
".Montgomery County, North Carolina",25760,25731,25862,25841,26085,354,1.374223602484472
".Deuel County, South Dakota",4294,4295,4290,4361,4354,59,1.3740102468560782
".Chowan County, North Carolina",13707,13703,13761,13898,13891,188,1.3715619756328883
".Montgomery County, Pennsylvania",856541,856998,864249,865044,868742,11744,1.3710960712913918
".Gallatin County, Kentucky",8693,8673,8763,8773,8792,119,1.3689175198435524
".Pepin County, Wisconsin",7320,7341,7374,7378,7441,100,1.366120218579235
".Calumet County, Wisconsin",52450,52485,52583,52712,53199,714,1.361296472831268
".Love County, Oklahoma",10145,10158,10237,10174,10296,138,1.3602759980285855
".Bon Homme County, South Dakota",6995,6970,7000,7064,7065,95,1.3581129378127232
".Woodford County, Kentucky",26873,26904,27082,27053,27268,364,1.3545194060953372
".Escambia County, Florida",321900,322568,323459,323860,326928,4360,1.354457906182044
".Cobb County, Georgia",766112,766378,766662,771840,776743,10365,1.35293534104674
".Franklin County, Indiana",22791,22788,22889,23083,23096,308,1.3514106445526743
".Floyd County, Virginia",15475,15470,15510,15623,15679,209,1.3505654281098547
".Scott County, Tennessee",21848,21876,21891,21999,22171,295,1.3502380080556573
".Polk County, Arkansas",19213,19177,19333,19334,19436,259,1.348045594128975
".New Castle County, Delaware",570713,570918,572029,575254,578592,7674,1.3446338176982127
".Brule County, South Dakota",5240,5241,5243,5301,5311,70,1.3358778625954197
".Oklahoma County, Oklahoma",796555,798241,799845,803103,808866,10625,1.3338689732661273
".Catoosa County, Georgia",67874,68006,68436,68836,68910,904,1.3318796593688305
".Chester County, Tennessee",17344,17375,17465,17558,17606,231,1.3318726937269372
".Capitol Planning Region, Connecticut",976275,962436,970142,972068,975328,12892,1.3205295639036132
".La Plata County, Colorado",55637,55673,56169,56553,56407,734,1.319265956108345
".Fillmore County, Minnesota",21237,21243,21331,21454,21522,279,1.3137448792202289
".Greene County, Indiana",30796,30793,30862,31071,31196,403,1.3086115079880505
".Harford County, Maryland",260922,261230,263302,263815,264644,3414,1.3084370041621636
".Hardin County, Kentucky",110696,110829,111878,111743,112273,1444,1.3044735130447351
".Poquoson city, Virginia",12456,12473,12628,12624,12635,162,1.300578034682081
".Oregon County, Missouri",8636,8608,8625,8703,8720,112,1.2968967114404817
".Tippecanoe County, Indiana",186255,186387,187423,188237,188792,2405,1.2912405036106414
".Wabasha County, Minnesota",21384,21407,21515,21652,21683,276,1.2906846240179575
".Warren County, North Carolina",18639,18596,18798,18677,18836,240,1.2876227265411235
".Ripley County, Missouri",10677,10669,10645,10714,10806,137,1.2831319659080267
".Ohio County, Indiana",5935,5928,5994,6097,6004,76,1.2805391743892165
".Rappahannock County, Virginia",7349,7320,7431,7453,7414,94,1.2790855898761735
".Wexford County, Michigan",33673,33693,33898,34018,34122,429,1.274017759035429
".Malheur County, Oregon",31567,31642,31677,31858,32044,402,1.2734818006145658
".Taney County, Missouri",56058,56062,56304,56749,56775,713,1.2718969638588604
".Golden Valley County, North Dakota",1730,1721,1755,1746,1743,22,1.2716763005780347
".DeKalb County, Alabama",71617,71659,71912,72082,72569,910,1.2706480304955527
".Gonzales County, Texas",19658,19681,19636,19816,19930,249,1.2666598840166854
".Nowata County, Oklahoma",9320,9320,9352,9413,9438,118,1.2660944206008584
".Ralls County, Missouri",10356,10358,10368,10410,10489,131,1.2649671687910389
".Rice County, Minnesota",67101,67102,67341,67523,67948,846,1.2607859793445702
".Henry County, Tennessee",32200,32149,32246,32382,32554,405,1.2577639751552796
".Giles County, Tennessee",30341,30340,30401,30540,30721,381,1.2557265746020236
".Waukesha County, Wisconsin",406975,407496,409108,410273,412591,5095,1.251919651084219
".Kalawao County, Hawaii",80,80,81,81,81,1,1.25
".Lawrence County, Alabama",33074,33089,33073,33187,33502,413,1.2487150027211706
".Wayne County, North Carolina",117321,117221,116857,117449,118686,1465,1.248710801987709
".Dale County, Alabama",49322,49257,49395,49495,49871,614,1.2448805806739385
".McCreary County, Kentucky",16886,16840,16804,16783,17050,210,1.2436337794622765
".Cameron County, Texas",421020,421480,422636,424911,426710,5230,1.2422212721485915
".Saratoga County, New York",235502,235793,237846,238468,238711,2918,1.2390552946471793
".Sioux County, Nebraska",1131,1140,1146,1127,1154,14,1.237842617152962
".Marion County, Kentucky",19579,19592,19739,19748,19834,242,1.2360181827468206
".Kearney County, Nebraska",6683,6688,6683,6706,6770,82,1.2269938650306749
".Merrick County, Nebraska",7665,7661,7667,7715,7755,94,1.2263535551206783
".Adams County, Indiana",35805,35849,35991,36151,36288,439,1.2260857422147746
".Gila County, Arizona",53271,53351,53549,53922,54003,652,1.2239304687353343
".Franklin County, Pennsylvania",155945,155949,156573,156951,157854,1905,1.2215845330084325
".Harding County, South Dakota",1310,1308,1325,1339,1324,16,1.2213740458015268
".Pettis County, Missouri",42984,43006,43213,43397,43530,524,1.2190582542341337
".Kenton County, Kentucky",169042,169271,169698,170280,171321,2050,1.212716366346825
".Haywood County, North Carolina",62088,62218,62522,62615,62969,751,1.2095735085684833
".Whitley County, Indiana",34181,34329,34470,34577,34742,413,1.208273602293672
".Mecklenburg County, Virginia",30315,30283,30333,30527,30648,365,1.2040244103579087
".Blount County, Alabama",59130,59107,59079,59516,59816,709,1.1990529342127516
".Jones County, Iowa",20644,20653,20826,20949,20900,247,1.1964735516372795
".Grand County, Colorado",15715,15747,15851,15734,15935,188,1.1963092586700605
".Wicomico County, Maryland",103588,103565,104114,104486,104800,1235,1.1922230374174616
".Gibson County, Tennessee",50411,50444,50468,50826,51045,601,1.192200115054254
".Chattooga County, Georgia",24970,24925,24844,24962,25222,297,1.1894273127753305
".Outagamie County, Wisconsin",190703,190966,191320,192269,193234,2268,1.1892838602434153
".Covington County, Alabama",37563,37506,37570,37603,37952,446,1.1873386044778107
".Bremer County, Iowa",24990,25011,25118,25254,25307,296,1.1844737895158064
".Schoharie County, New York",29718,29753,30132,30091,30105,352,1.1844673261996097
".Somerset County, New Jersey",345353,344754,346498,347047,348842,4088,1.1837163713649512
".McNairy County, Tennessee",25855,25857,25846,25993,26163,306,1.1835234964223555
".Butler County, Nebraska",8374,8360,8454,8443,8459,99,1.1822307141151183
".District of Columbia, District of Columbia",689548,670839,669037,670949,678972,8133,1.1794682893721684
".Bates County, Missouri",16038,16053,16095,16170,16242,189,1.1784511784511784
".Hyde County, North Carolina",4588,4553,4643,4656,4607,54,1.176983435047951
".Morris County, New Jersey",509288,508439,510613,511219,514423,5984,1.174973688757638
".Nacogdoches County, Texas",64646,64616,64778,64994,65375,759,1.174086563747177
".Tulare County, California",473116,473914,477176,477884,479468,5554,1.1739192925202278
".Elko County, Nevada",53700,53664,53852,53979,54293,629,1.1713221601489758
".Skagit County, Washington",129524,129902,131005,131322,131417,1515,1.1696673975479448
".Schuyler County, Missouri",4029,4006,4015,4000,4053,47,1.1665425663936462
".Porter County, Indiana",173207,173318,174551,174848,175335,2017,1.164502589387265
".Newton County, Indiana",13835,13799,13820,13839,13960,161,1.1637152150343333
".Columbia County, Pennsylvania",64722,64686,64981,65289,65439,753,1.1634374710299435
".Blue Earth County, Minnesota",69114,69204,69380,69603,70006,802,1.1604016552362764
".Watauga County, North Carolina",54077,54122,54968,55013,54748,626,1.1576085951513584
".Carter County, Tennessee",56348,56371,56080,56485,57022,651,1.1553205082700362
".Carter County, Oklahoma",48006,48042,48254,48336,48596,554,1.1540224138649335
".Scott County, Indiana",24388,24377,24422,24500,24657,280,1.1481056257175661
".Schoolcraft County, Michigan",8050,8057,8048,8174,8149,92,1.1428571428571428
".Orange County, Texas",84810,84754,84666,85048,85722,968,1.1413748378728923
".Clark County, Idaho",789,792,793,810,801,9,1.1406844106463878
".Oldham County, Texas",1758,1763,1734,1761,1783,20,1.1376564277588168
".Barren County, Kentucky",44481,44505,44598,44872,45008,503,1.1308199006317303
".St. Mary's County, Maryland",113777,113999,114650,114783,115281,1282,1.1267655149986378
".Warren County, Indiana",8434,8423,8449,8488,8518,95,1.1263931705003556
".Colonial Heights city, Virginia",18170,18189,18225,18278,18393,204,1.1227297743533295
".Northwest Hills Planning Region, Connecticut",112465,112202,112953,113277,113463,1261,1.1212377184012805
".Washington County, Florida",25323,25320,24867,25405,25602,282,1.1136121312640683
".Humphreys County, Tennessee",18988,18998,19178,19023,19209,211,1.1112281440910048
".Pendleton County, Kentucky",14648,14648,14635,14703,14810,162,1.1059530311305297
".Lancaster County, Nebraska",322613,323165,323404,324434,326716,3551,1.100699599830137
".Pontotoc County, Mississippi",31187,31192,31325,31367,31535,343,1.0998172315387822
".Houston County, Alabama",107202,107284,107470,108047,108462,1178,1.0988600958937333
".Dukes County, Massachusetts",20605,20593,21127,20962,20819,226,1.0968211599126425
".Sterling County, Texas",1370,1382,1380,1426,1397,15,1.094890510948905
".Carbon County, Pennsylvania",64753,64752,65522,65493,65458,706,1.0902969746575448
".Jackson County, Kentucky",12957,12963,12980,12989,13104,141,1.0882148645519796
".Geneva County, Alabama",26658,26698,26620,26760,26988,290,1.0878535524045314
".Baker County, Oregon",16671,16731,16880,16937,16912,181,1.0857177133945173
".Brown County, Indiana",15474,15485,15592,15587,15653,168,1.0856921287320667
".Hunterdon County, New Jersey",128950,128786,129671,129805,130183,1397,1.0833656455990694
".Washington County, Nebraska",20862,20927,20991,21167,21152,225,1.0785159620362381
".Angelina County, Texas",86400,86388,86730,87124,87319,931,1.0775462962962963
".Johnson County, Georgia",9188,9183,8999,9211,9282,99,1.0774923813670005
".Clarke County, Georgia",128670,128551,129206,129726,129933,1382,1.0740654387192041
".Brown County, Illinois",6240,6227,6432,6316,6294,67,1.0737179487179487
".Dorchester County, Maryland",32529,32530,32594,32583,32879,349,1.0728888069107565
".Olmsted County, Minnesota",162850,163037,163742,164036,164784,1747,1.0727663494012896
".Clay County, Iowa",16380,16336,16454,16507,16511,175,1.0683760683760684
".Lavaca County, Texas",20342,20354,20538,20653,20571,217,1.0667584308327598
".Marion County, Iowa",33418,33414,33441,33630,33770,356,1.0652941528517565
".Shelby County, Texas",24018,23924,23984,24061,24179,255,1.0617037222083439
".Allegan County, Michigan",120514,120669,121068,121290,121939,1270,1.0538194732562192
".Taylor County, Iowa",5893,5862,5866,5875,5924,62,1.052095706770745
".Hillsborough County, New Hampshire",422938,422913,424413,427493,427354,4441,1.050035702632537
".Grand Traverse County, Michigan",95251,95425,95969,96298,96421,996,1.045658313298548
".Lancaster County, Pennsylvania",552989,552821,556292,556660,558589,5768,1.0430587226870698
".Guthrie County, Iowa",10621,10612,10588,10681,10722,110,1.03568402222013
".Adams County, Washington",20609,20607,20647,20898,20820,213,1.0335290407103692
".York County, Virginia",70052,70232,71104,71164,70952,720,1.0278079141209386
".Houston County, Tennessee",8288,8308,8298,8247,8393,85,1.0255791505791505
".Douglas County, Oregon",111203,111295,112149,112290,112435,1140,1.0251521991313184
".Liberty County, Montana",1956,1954,1933,1974,1974,20,1.0224948875255624
United States,331464948,331526933,332048977,333271411,334914895,3387962,1.0221177293232224
".Richmond city, Virginia",226548,226936,227140,228367,229247,2311,1.020092872150714
".Thurston County, Washington",294792,295998,298196,298639,299003,3005,1.019362804960786
".Muskegon County, Michigan",174736,174784,175550,175539,176564,1780,1.0186796080944969
".Rockland County, New York",338337,337367,339786,340357,340807,3440,1.0167377496401517
".Goshen County, Wyoming",12504,12515,12568,12636,12642,127,1.0156749840051182
".Marshall County, Mississippi",33753,33781,33755,33905,34123,342,1.013243267265132
".Leon County, Florida",292206,293955,296007,297282,296913,2958,1.012299542103858
".Franklin County, Florida",12452,12468,12183,12492,12594,126,1.0118856408609058
".Ogemaw County, Michigan",20768,20780,20774,20919,20990,210,1.011171032357473
".Asotin County, Washington",22286,22324,22469,22536,22549,225,1.009602440994346
".Red River County, Texas",11589,11561,11561,11605,11678,117,1.009578048149107
".Sebastian County, Arkansas",127797,127808,128342,129109,129098,1290,1.0094133665109508
".Oceana County, Michigan",26656,26712,26860,26920,26981,269,1.0091536614645857
".Sioux County, Iowa",35863,35885,35959,36127,36246,361,1.006608482279787
".Buffalo County, Nebraska",50084,50193,50300,50532,50697,504,1.0063094002076511
".Owen County, Indiana",21327,21318,21514,21487,21532,214,1.0034228911708163
".De Soto Parish, Louisiana",26812,26845,26949,26856,27114,269,1.0032821124869462
".Custer County, Montana",11869,11866,11961,12000,11985,119,1.00261184598534
".Pamlico County, North Carolina",12270,12300,12342,12234,12423,123,1.0024449877750612
".Greater Bridgeport Planning Region, Connecticut",325774,324387,326752,327125,327651,3264,1.0019215775353465
".Independence County, Arkansas",37931,37940,38100,38254,38320,380,1.0018190925628114
".Beltrami County, Minnesota",46238,46255,46481,46511,46718,463,1.0013408884467323
".Washington County, Wisconsin",136758,136801,137253,137756,138168,1367,0.9995758931835799
".Iowa County, Wisconsin",23717,23719,23807,23958,23956,237,0.999283214571826
".Aleutians East Borough, Alaska",3421,3427,3417,3430,3461,34,0.9938614440222158
".Emanuel County, Georgia",22770,22893,22899,22946,23119,226,0.992534036012297
".Carter County, Montana",1411,1404,1413,1403,1418,14,0.9922041105598866
".Yankton County, South Dakota",23313,23286,23353,23412,23517,231,0.990863466735298
".White County, Indiana",24698,24673,24643,24660,24917,244,0.98793424568791
".Broward County, Florida",1944381,1943398,1935575,1946889,1962531,19133,0.9840149641454016
".Addison County, Vermont",37365,37355,37408,37555,37720,365,0.9768499933092466
".Jackson County, Kansas",13231,13239,13263,13292,13368,129,0.9749829944826544
".Caroline County, Maryland",33292,33270,33429,33427,33593,323,0.9702030517842124
".Houghton County, Michigan",37354,37237,37507,37160,37599,362,0.9691063875354714
".Berks County, Pennsylvania",428851,428671,429635,431573,432821,4150,0.9677020690169779
".Benton County, Iowa",25584,25549,25738,25742,25796,247,0.9654471544715447
".Gadsden County, Florida",43819,43411,43599,43393,43833,422,0.9630525571099295
".Plymouth County, Massachusetts",530819,530200,533059,533248,535308,5108,0.9622865797946193
".Goodhue County, Minnesota",47580,47578,48042,48041,48035,457,0.960487599831862
".Arenac County, Michigan",15003,15001,15016,15123,15145,144,0.9598080383923214
".Chelan County, Washington",79081,79238,79778,80038,79997,759,0.959775420138845
".Howard County, Maryland",332316,332814,335328,335366,336001,3187,0.9590269502521697
".Itawamba County, Mississippi",23862,23865,23885,23971,24093,228,0.9554940910233845
".Dodge County, Minnesota",20866,20889,20952,20992,21088,199,0.9537045912009968
".Kent County, Maryland",19198,19120,19244,19295,19303,183,0.9532242941973122
".Chippewa County, Wisconsin",66300,66341,66590,66753,66970,629,0.9487179487179488
".Oneida County, Wisconsin",37842,37869,38249,38193,38226,357,0.9433962264150944
".McHenry County, Illinois",310213,309882,311543,311558,312800,2918,0.940644009116317
".Platte County, Nebraska",34295,34287,34295,34355,34609,322,0.9389123778976527
".Conejos County, Colorado",7459,7451,7582,7587,7521,70,0.9384636010189034
".Routt County, Colorado",24825,24832,25058,25072,25064,232,0.9345417925478349
".Okmulgee County, Oklahoma",36710,36693,36848,37011,37035,342,0.9316262598746936
".Anne Arundel County, Maryland",588270,589106,592085,593347,594582,5476,0.9308650789603414
".Custer County, Nebraska",10532,10483,10486,10504,10581,98,0.9304975313330801
".Greene County, Ohio",167969,168131,168236,169027,169691,1560,0.9287428037316409
".Barton County, Missouri",11638,11623,11665,11695,11731,108,0.9279945007733288
".St. Francois County, Missouri",66919,66443,67010,66906,67058,615,0.9190215036088405
".Brown County, Wisconsin",268740,268951,268899,270068,271417,2466,0.9176155391828533
".Dearborn County, Indiana",50676,50750,50875,50900,51215,465,0.9175941273975847
".Carroll County, Indiana",20308,20339,20525,20514,20525,186,0.9158952137088832
".Sherman County, Nebraska",2959,2956,2966,3006,2983,27,0.9124704291990536
".Iron County, Michigan",11633,11634,11610,11705,11740,106,0.9112008940084243
".Fulton County, Georgia",1066675,1069394,1062451,1073698,1079105,9711,0.9103991375067382
".Laurel County, Kentucky",62608,62727,62580,62879,63296,569,0.9088295425504729
".Robeson County, North Carolina",116514,116309,116142,116466,117365,1056,0.9063288531850251
".Churchill County, Nevada",25518,25572,25664,25798,25803,231,0.9052433576299084
".LaGrange County, Indiana",40453,40542,40527,40854,40907,365,0.9022816601982548
".Kauai County, Hawaii",73296,73190,73829,73783,73851,661,0.9018227461253001
".Ste. Genevieve County, Missouri",18478,18476,18569,18613,18642,166,0.8983656239852799
".Martin County, Indiana",9811,9809,9804,9827,9897,88,0.8969524003669351
".Thomas County, Nebraska",669,671,676,665,677,6,0.8968609865470852
".Daviess County, Indiana",33380,33357,33396,33496,33656,299,0.8957459556620732
".Talbot County, Maryland",37523,37488,37756,37814,37823,335,0.8927857580683848
".Western Connecticut Planning Region, Connecticut",620519,618368,623258,622857,623907,5539,0.8926398708178154
".Faulk County, South Dakota",2130,2132,2124,2122,2151,19,0.892018779342723
".Baker County, Florida",28255,28116,28669,27786,28368,252,0.891877543797558
".Buckingham County, Virginia",16831,16828,16950,16988,16978,150,0.8912126433367001
".McDuffie County, Georgia",21628,21607,21619,21690,21799,192,0.8877381172554096
".Henderson County, Tennessee",27834,27824,27906,27907,28070,246,0.883811166199612
".Burke County, North Carolina",87551,87565,87589,87972,88338,773,0.8829139587212025
".Callaway County, Missouri",44287,44340,44640,44723,44731,391,0.8828775938763068
".Wadena County, Minnesota",14062,14117,14141,14236,14241,124,0.8818091309913241
".Dauphin County, Pennsylvania",286402,286710,288252,288687,289234,2524,0.8812787620198184
".Portage County, Wisconsin",70371,70405,69433,70634,71024,619,0.8796237086299754
".Clay County, Georgia",2845,2828,2867,2853,2853,25,0.8787346221441126
".Cherokee County, South Carolina",56224,56220,56098,56121,56714,494,0.878628343767786
".Whitfield County, Georgia",102867,102784,102712,103095,103687,903,0.8778325410481496
".Adair County, Oklahoma",19497,19456,19442,19516,19627,171,0.8770580089244499
".Otter Tail County, Minnesota",60095,60099,60231,60544,60626,527,0.876944837340877
".Bristol County, Massachusetts",579208,576772,579756,579744,581841,5069,0.8751605640806067
".Sampson County, North Carolina",59042,59085,59022,59027,59601,516,0.8739541343450424
".Colleton County, South Carolina",38602,38537,38459,38580,38874,337,0.8730117610486504
".Washington County, Colorado",4817,4813,4868,4847,4855,42,0.8719119784097987
".Kern County, California",909229,905910,912709,916751,913820,7910,0.869967851883299
".Phelps County, Nebraska",8971,8979,8923,8988,9057,78,0.869468286701594
".Augusta County, Virginia",77485,77574,77764,77939,78247,673,0.8685552042330773
".Lehigh County, Pennsylvania",374571,374501,375889,376274,377754,3253,0.8684601851184421
".Sevier County, Tennessee",98381,98562,99435,98806,99415,853,0.8670373344446589
".Webster County, Mississippi",9924,9902,9970,9944,9988,86,0.8665860540104797
".Hot Springs County, Wyoming",4619,4621,4595,4623,4661,40,0.8659883091578264
".Harrison County, Mississippi",208620,208809,209485,210443,210612,1803,0.8642507909117055
".Phillips County, Montana",4220,4213,4210,4228,4249,36,0.8530805687203791
".La Paz County, Arizona",16546,16569,16385,16535,16710,141,0.8521697086909222
".Ripley County, Indiana",28985,28980,29015,29030,29227,247,0.8521649128859755
".Cole County, Missouri",77280,76621,76603,76956,77278,657,0.8501552795031055
".Garvin County, Oklahoma",25655,25647,25770,25771,25865,218,0.8497368933931007
".Cheyenne County, Kansas",2616,2614,2637,2618,2636,22,0.8409785932721712
".Albany County, New York",314851,314018,316178,315921,316659,2641,0.838809468605785
".Worcester County, Massachusetts",862116,859669,862224,862873,866866,7197,0.8348064529599264
".Bossier Parish, Louisiana",128732,128721,129323,129153,129795,1074,0.8342913960786751
".Harrison County, Indiana",39656,39676,39805,39790,40006,330,0.8321565462981642
".Buffalo County, Wisconsin",13301,13309,13325,13390,13419,110,0.8270054883091497
".Knox County, Ohio",62721,62803,62543,63196,63320,517,0.824285327083433
".Laurens County, Georgia",49570,49535,49524,49710,49941,406,0.8190437764777083
".Hall County, Texas",2815,2795,2842,2818,2818,23,0.8170515097690942
".Rockcastle County, Kentucky",16036,16059,16134,16225,16190,131,0.8169119481167374
".Delaware County, Iowa",17484,17458,17553,17607,17600,142,0.812171127888355
".Knox County, Maine",40604,40654,41069,41179,40977,323,0.79548812924835
".Colusa County, California",21836,21864,21919,21909,22037,173,0.7922696464553948
".Pontotoc County, Oklahoma",38071,38095,38184,38032,38396,301,0.7906280370885976
".Hale County, Alabama",14788,14772,14726,14599,14888,116,0.7844197998377063
".Dunn County, Wisconsin",45425,45440,44518,45622,45794,354,0.779306549257017
".Coshocton County, Ohio",36606,36584,36658,36615,36869,285,0.7785608916571054
".Camden County, New Jersey",523498,523122,524093,524649,527196,4074,0.778226468869031
".Salem city, Virginia",25347,25403,25416,25700,25600,197,0.7772122933680514
".McDowell County, North Carolina",44582,44547,44530,44755,44893,346,0.7760979767619218
".Clearwater County, Minnesota",8528,8578,8582,8638,8644,66,0.773921200750469
".Decatur County, Iowa",7640,7606,7668,7695,7665,59,0.7722513089005236
".Gove County, Kansas",2722,2714,2747,2742,2735,21,0.7714915503306392
".Boyle County, Kentucky",30614,30753,30604,30851,30988,235,0.7676226563010387
".Salem County, New Jersey",64830,64841,65045,65157,65338,497,0.7666203917939225
".Medina County, Ohio",182475,182646,183394,183489,184042,1396,0.7650363063433347
".Cass County, Texas",28448,28442,28573,28538,28659,217,0.7627952755905512
".Lunenburg County, Virginia",11936,11947,12001,12002,12038,91,0.7623994638069705
".Grant County, Minnesota",6074,6093,6149,6121,6139,46,0.757326308857425
".Fresno County, California",1008646,1009552,1013103,1015359,1017162,7610,0.7544767936421698
".Yakutat City and Borough, Alaska",663,682,710,685,687,5,0.7541478129713424
".Morris County, Texas",11974,11976,12007,12052,12066,90,0.7516285284783698
".Rio Blanco County, Colorado",6526,6520,6442,6549,6569,49,0.7508427827152927
".Cook County, Minnesota",5601,5597,5629,5721,5639,42,0.7498660953401178
".Iosco County, Michigan",25227,25184,25350,25473,25373,189,0.7491972886193364
".Osage County, Oklahoma",45825,45787,45882,45852,46130,343,0.7484997272231315
".Campbell County, Wyoming",47030,47147,46543,47059,47498,351,0.7463321284286626
".Branch County, Michigan",44873,44884,45215,44502,45215,331,0.73763733202594
".Itasca County, Minnesota",45014,45034,45099,45194,45365,331,0.7353267872217533
".Mitchell County, Texas",8990,9009,9042,8938,9075,66,0.7341490545050056
".Cherry County, Nebraska",5453,5452,5447,5485,5492,40,0.7335411699981661
".West Feliciana Parish, Louisiana",15308,15259,15495,15396,15371,112,0.7316435850535667
".Clark County, Kentucky",36987,37035,36895,36992,37304,269,0.7272825587368535
".Cumberland County, North Carolina",334733,335470,337888,336781,337890,2420,0.7229642730175991
".Jerauld County, South Dakota",1663,1648,1645,1662,1660,12,0.7215874924834637
".Washington County, Maryland",154704,154697,155143,155257,155813,1116,0.7213775985107043
".Pike County, Alabama",33002,32900,32746,33008,33137,237,0.7181382946488092
".Jeff Davis County, Georgia",14777,14800,14860,14891,14906,106,0.7173309873451986
".South Central Connecticut Planning Region, Connecticut",570455,564076,568450,568402,568158,4082,0.7155691509409156
".Lander County, Nevada",5733,5728,5761,5761,5769,41,0.7151578580150009
".Petersburg Borough, Alaska",3397,3403,3381,3370,3427,24,0.7065057403591404
".Lynchburg city, Virginia",79007,78979,79114,79228,79535,556,0.7037351120786766
".Douglas County, Nebraska",584531,585431,585452,586106,589540,4109,0.702956729412127
".Kinney County, Texas",3132,3126,3122,3131,3148,22,0.70242656449553
".Harrison County, Missouri",8163,8163,8184,8217,8220,57,0.6982726938625505
".Bledsoe County, Tennessee",14917,14956,14837,14824,15060,104,0.6971911242206877
".Sedgwick County, Kansas",523836,524821,524423,525368,528469,3648,0.6964011637229973
".Clinton County, Michigan",79130,79170,79464,79652,79720,550,0.6950587640591431
".Morrison County, Minnesota",34026,34014,34079,34237,34250,236,0.6935872568036208
".Harrison County, Iowa",14582,14569,14690,14680,14670,101,0.6926347551776162
".Wayne County, Iowa",6502,6512,6531,6490,6557,45,0.6920947400799754
".Abbeville County, South Carolina",24294,24266,24262,24338,24434,168,0.6915287725364287
".Washakie County, Wyoming",7679,7657,7719,7724,7710,53,0.6901940356817294
".Screven County, Georgia",14065,14077,14062,13970,14174,97,0.6896551724137931
".Howard County, Nebraska",6470,6483,6521,6509,6527,44,0.6800618238021638
".Lebanon County, Pennsylvania",143253,143278,143759,143902,144252,974,0.6799159528945293
".McLean County, North Dakota",9780,9766,9823,9858,9832,66,0.6748466257668712
".Hughes County, Oklahoma",13364,13346,13401,13434,13436,90,0.673451062556121
".Russell County, Kansas",6691,6678,6697,6733,6723,45,0.6725452099835599
".Midland County, Michigan",83487,83478,83479,83762,84039,561,0.6719609040928528
".Webb County, Texas",267113,267363,267400,267619,269148,1785,0.6682565056736287
".Luzerne County, Pennsylvania",325613,325217,325942,326496,327388,2171,0.6667424212178261
".Kitsap County, Washington",275612,275823,276589,277813,277658,1835,0.665791039577377
".Morrow County, Oregon",12186,12221,12359,12292,12302,81,0.6646971935007385
".Mitchell County, North Carolina",14899,14900,14975,15048,14999,99,0.6644741257802537
".Pope County, Minnesota",11306,11325,11410,11420,11400,75,0.6633645851760127
".Union County, Florida",16143,15425,15850,15514,15532,107,0.6628259926903302
".Prentiss County, Mississippi",25006,24971,24962,24891,25135,164,0.6558425977765336
".Prince Edward County, Virginia",21849,21906,21962,21899,22049,143,0.6544921964391963
".Muskogee County, Oklahoma",66348,66246,66267,66307,66677,431,0.649605112437451
".Yamhill County, Oregon",107726,107945,108481,108362,108644,699,0.6488684254497522
".Klamath County, Oregon",69419,69553,70246,70190,70003,450,0.6482375142252121
".Pueblo County, Colorado",168165,168337,169316,169472,169422,1085,0.6451996551006453
".Chittenden County, Vermont",168321,168395,169338,169357,169481,1086,0.6451957866219901
".Washington County, Vermont",59800,59757,60033,60115,60142,385,0.6438127090301003
".Smith County, Kansas",3575,3567,3573,3572,3590,23,0.6433566433566433
".Stevens County, Minnesota",9674,9666,9689,9615,9728,62,0.6408931155675005
".Surry County, Virginia",6558,6551,6533,6527,6593,42,0.6404391582799633
".Summit County, Utah",42367,42489,43179,43045,42759,270,0.6372884556376425
".Davis County, Iowa",9109,9111,9150,9147,9169,58,0.6367329015259634
".Clinton County, Pennsylvania",37444,37370,38015,37776,37607,237,0.6329451981625895
".Taylor County, Wisconsin",19908,19932,19938,19941,20058,126,0.6329113924050633
".Windsor County, Vermont",57737,57738,58350,58150,58101,363,0.628712957029288
".Oswego County, New York",117528,117429,117984,118239,118162,733,0.6236811653393234
".Grundy County, Missouri",9806,9754,9757,9844,9815,61,0.6220681215582297
".Shawano County, Wisconsin",40867,40855,40829,40987,41109,254,0.6215283725255096
".Campbell County, Kentucky",93068,93127,92828,93272,93702,575,0.6178278248162633
".Kewaunee County, Wisconsin",20568,20563,20589,20653,20690,127,0.617464021781408
".Lincoln County, Oregon",50399,50510,51013,50752,50821,311,0.6170757356296752
".Lawrence County, Arkansas",16221,16218,16329,16194,16318,100,0.61648480364959
".Cheyenne County, Nebraska",9464,9483,9498,9526,9541,58,0.6128486897717667
".Van Buren County, Iowa",7206,7222,7258,7252,7266,44,0.6106022758812101
".Marshall County, Indiana",46085,46071,46160,46378,46352,281,0.6097428664424434
".Beauregard Parish, Louisiana",36555,36605,36668,36624,36827,222,0.6073040623717686
".Shelby County, Iowa",11760,11735,11780,11711,11806,71,0.6037414965986395
".Colquitt County, Georgia",45892,45891,45763,45830,46167,276,0.601412010807984
".Carbon County, Utah",20416,20487,20360,20540,20609,122,0.5975705329153604
".Coffee County, Georgia",43092,43060,43046,43247,43317,257,0.5963984034159473
".Benton County, Minnesota",41376,41355,41533,41509,41600,245,0.5921307037896365
".Santa Fe County, New Mexico",154821,155043,155400,155761,155956,913,0.5897132817899381
".Highland County, Ohio",43313,43359,43444,43426,43614,255,0.5887377923487175
".Cascade County, Montana",84409,84407,84551,85001,84900,493,0.5840609413688114
".Ulster County, New York",181841,181271,183489,182320,182333,1062,0.5840267046485665
".Schuylkill County, Pennsylvania",143056,142963,143157,143188,143786,823,0.5752991835365172
".Madison County, Missouri",12626,12626,12664,12757,12698,72,0.5702518612387137
".Perry County, Pennsylvania",45830,45825,45943,46113,46083,258,0.562950032729653
".San Bernardino County, California",2181660,2183391,2193087,2194908,2195611,12220,0.5601239423191515
".Will County, Illinois",697298,696826,699176,698046,700728,3902,0.5595885833603423
".Butler County, Ohio",390352,390878,387619,389728,393043,2165,0.5546276181497725
".Pierce County, Washington",921147,923589,927402,926479,928696,5107,0.5544174816831624
".Hot Spring County, Arkansas",33044,33075,33079,33149,33258,183,0.5538070451519187
".Sheridan County, North Dakota",1265,1259,1263,1286,1266,7,0.5533596837944664
".Weakley County, Tennessee",32903,32903,32883,33043,33084,181,0.5501018144242167
".Price County, Wisconsin",14047,14025,14048,14159,14102,77,0.548159749412686
".Oliver County, North Dakota",1876,1869,1876,1862,1879,10,0.5330490405117271
".Crockett County, Tennessee",13912,13908,13990,13862,13982,74,0.5319148936170213
".Osage County, Kansas",15765,15741,15752,15705,15824,83,0.5264827148747225
".Lamoille County, Vermont",25945,25924,26149,26103,26060,136,0.5241857776064752
".Clarendon County, South Carolina",31145,30841,30961,30927,31004,163,0.5233584845079466
".Marinette County, Wisconsin",41874,41889,41858,41966,42106,217,0.5182213306586426
".Woodson County, Kansas",3123,3099,3084,3117,3115,16,0.5123278898495036
".Kent County, Rhode Island",170360,170406,171077,171134,171278,872,0.511857243484386
".Calhoun County, South Carolina",14122,14114,14138,14197,14186,72,0.5098427984704716
".Bourbon County, Kansas",14362,14335,14326,14443,14408,73,0.5082857540732488
".El Dorado County, California",191189,191245,193704,192787,192215,970,0.507351364356736
".Portage County, Ohio",161796,161853,159076,161742,162665,812,0.5018665479987144
".Rush County, Indiana",16748,16763,16679,16672,16847,84,0.5015524241700501
".Athens County, Ohio",62437,62393,59096,60881,62706,313,0.5013053157582843
".Winston County, Alabama",23547,23493,23655,23741,23611,118,0.5011254087569541
".Gilliam County, Oregon",1996,2016,2013,2008,2026,10,0.501002004008016
".Choctaw County, Oklahoma",14204,14205,14363,14407,14276,71,0.4998591945930724
".Delaware County, Indiana",111909,111762,112057,112163,112321,559,0.49951299716734127
".Tate County, Mississippi",28067,28121,28103,28259,28261,140,0.4988064274771084
".Hardeman County, Tennessee",25464,25440,25260,25511,25567,127,0.49874332390826265
".Latimer County, Oklahoma",9444,9479,9454,9556,9526,47,0.49767047861075814
".DeWitt County, Texas",19819,19833,19949,19754,19929,96,0.4843836722337151
".Caswell County, North Carolina",22733,22697,22691,22431,22807,110,0.4838780627281925
".Franklin County, Kansas",25983,26000,26002,25959,26125,125,0.48108378555209175
".Limestone County, Texas",22149,22144,22060,22164,22250,106,0.47857691092148635
".Butler County, Kentucky",12369,12316,12302,12365,12375,59,0.47699894898536666
".Rock County, Nebraska",1263,1265,1275,1241,1271,6,0.4750593824228029
".Walworth County, Wisconsin",105231,105323,105296,105664,105822,499,0.47419486653172543
".Jefferson County, Oklahoma",5335,5322,5390,5408,5347,25,0.4686035613870665
".Washington County, Missouri",23515,23424,23392,23392,23534,110,0.4677865192430364
".Greene County, Mississippi",13540,13538,13648,13566,13601,63,0.465288035450517
".Coos County, New Hampshire",31260,31227,31379,31476,31372,145,0.46385156749840056
".Stanton County, Nebraska",5850,5829,5837,5765,5856,27,0.46153846153846156
".Southeastern Connecticut Planning Region, Connecticut",280428,278342,278820,279257,279634,1292,0.4607243213944399
".Converse County, Wyoming",13751,13746,13662,13765,13809,63,0.45814849829103343
".Culberson County, Texas",2187,2186,2182,2163,2196,10,0.4572473708276178
".Charlevoix County, Michigan",26056,26041,26199,26173,26159,118,0.4528707399447344
".Pike County, Arkansas",10169,10162,10114,10159,10208,46,0.45235519716786315
".Lapeer County, Michigan",88620,88583,88662,88632,88977,394,0.4445948995712029
".Appling County, Georgia",18445,18376,18423,18437,18457,81,0.43914339929520196
".Moffat County, Colorado",13295,13269,13165,13205,13327,58,0.4362542309138774
".Putnam County, New York",97678,97635,98228,98312,98060,425,0.43510309383894025
".Kent County, Michigan",657977,658492,658852,658920,661354,2862,0.43496961139979057
".Mason County, Michigan",29053,29033,29339,29318,29159,126,0.4336901524799504
".Wichita County, Texas",129361,129620,130073,130220,130180,560,0.4328970864480021
".Aroostook County, Maine",67099,67063,67075,67322,67351,288,0.42921653079777644
".Lafayette County, Missouri",32983,33055,32834,32967,33196,141,0.4274929509141072
".Whitman County, Washington",47970,47807,43224,47579,48012,205,0.4273504273504274
".Bergen County, New Jersey",955743,953690,955383,953540,957736,4046,0.423335561965926
".Wharton County, Texas",41571,41564,41652,41740,41739,175,0.4209665391739434
".Dutchess County, New York",297021,295901,298776,297609,297150,1249,0.42050898758000277
".Buchanan County, Iowa",20562,20605,20703,20689,20691,86,0.4182472522128198
".Grundy County, Iowa",12326,12333,12358,12355,12384,51,0.41375953269511606
".Orleans County, Vermont",27401,27403,27591,27562,27516,113,0.41239370825882266
".Greene County, North Carolina",20454,20446,20280,20367,20530,84,0.41067761806981523
".Delaware County, New York",44311,44231,44718,44774,44410,179,0.4039628986030557
".Tift County, Georgia",41357,41387,41082,41335,41554,167,0.40380104939913436
".Norfolk County, Massachusetts",725932,724554,724471,725469,727473,2919,0.4021037783153243
".Staunton city, Virginia",25753,25812,25689,25940,25915,103,0.3999534034869724
".Dickinson County, Kansas",18401,18373,18465,18355,18445,72,0.39128308244117166
".Spencer County, Indiana",19812,19833,19841,19849,19910,77,0.3886533414092469
".Schenectady County, New York",158052,159289,160046,159694,159902,613,0.3878470376838003
".Marathon County, Wisconsin",138026,138078,137755,137955,138612,534,0.38688363062031794
".Victoria County, Texas",91322,91311,90896,91074,91664,353,0.3865443157180088
".Clinch County, Georgia",6741,6720,6702,6679,6746,26,0.38569945112001186
".Washington County, Pennsylvania",209369,209434,210054,209940,210232,798,0.3811452507295731
".Shelby County, Indiana",45049,45060,45101,45189,45231,171,0.3795866722901729
".El Paso County, Texas",865661,866606,867499,867239,869880,3274,0.3782080976271312
".Gregory County, South Dakota",3996,4003,3957,3999,4018,15,0.37537537537537535
".Atlantic County, New Jersey",274536,274190,274956,275382,275213,1023,0.37262872628726285
".Comanche County, Oklahoma",121128,121125,122324,122225,121574,449,0.3706822534839178
".Huntington County, Indiana",36669,36646,36788,36800,36781,135,0.3681583899206414
".Antelope County, Nebraska",6292,6279,6295,6305,6302,23,0.36554354736172917
".Madison County, Tennessee",98833,98832,98557,99172,99193,361,0.36526261471370897
".Floyd County, Indiana",80479,80519,80595,80621,80809,290,0.36034244958312106
".Holmes County, Ohio",44214,44227,44349,44375,44386,159,0.35961460170986564
".Luce County, Michigan",6414,6412,5977,6274,6435,23,0.3585905830994699
".Ashland County, Wisconsin",16036,16022,16048,16040,16079,57,0.35545023696682465
".Meade County, Kentucky",30005,30026,30119,30010,30131,105,0.34994167638726875
".Whitley County, Kentucky",36714,36698,36761,36908,36825,127,0.34591708884894046
".Lake of the Woods County, Minnesota",3765,3765,3826,3886,3778,13,0.3452855245683931
".Candler County, Georgia",10988,11022,10947,10962,11059,37,0.336730979250091
".Grand County, Utah",9664,9674,9671,9771,9706,32,0.33112582781456956
".Lake County, Indiana",498705,498957,499257,499657,500598,1641,0.3290522453153668
".Mackinac County, Michigan",10830,10816,10907,10962,10851,35,0.32317636195752536
".Clallam County, Washington",77166,77367,78466,77684,77616,249,0.32268097348573205
".Rock County, Wisconsin",163690,163758,164115,163841,164278,520,0.31767365141425863
".Carroll County, Virginia",29158,29148,29098,29118,29239,91,0.31209273612730637
".Chase County, Kansas",2573,2571,2604,2568,2579,8,0.3109211037699184
".Bracken County, Kentucky",8401,8400,8440,8435,8426,26,0.3094869658374003
".Seward County, Nebraska",17608,17618,17556,17625,17671,53,0.30099954566106313
".Dickinson County, Michigan",25955,25904,25819,25943,25982,78,0.30052013099595454
".Wood County, Ohio",132247,132256,130310,131642,132650,394,0.29792736319160357
".Perry County, Ohio",35406,35446,35464,35471,35551,105,0.29655990510083036
".Van Buren County, Michigan",75585,75574,75678,75669,75798,224,0.2963550969107627
".Adams County, Ohio",27471,27440,27574,27459,27521,81,0.2948563940155073
".Clark County, Wisconsin",34661,34672,34762,34732,34774,102,0.2942788725080061
".Florence County, South Carolina",137060,136817,136401,136740,137214,397,0.28965416605866046
".Howard County, Indiana",83664,83589,83650,83546,83831,242,0.2892522470835724
".Jasper County, Iowa",37805,37810,37874,37949,37919,109,0.2883216505753207
".Washington County, Virginia",53936,53895,53735,53855,54050,155,0.28737763274992584
".Moniteau County, Missouri",15474,15212,15310,15260,15256,44,0.28434793847744605
".Essex County, Massachusetts",809827,807791,807360,806499,810089,2298,0.28376431015513187
".Okfuskee County, Oklahoma",11310,11268,11222,11227,11300,32,0.28293545534924847
".Perry County, Indiana",19170,19155,19334,19207,19209,54,0.28169014084507044
".Andrews County, Texas",18608,18612,18411,18324,18664,52,0.2794496990541703
".Kosciusko County, Indiana",80233,80141,80237,80564,80364,223,0.27794049829870504
".Esmeralda County, Nevada",730,734,735,747,736,2,0.273972602739726
".Madison County, Nebraska",35589,35530,35395,35414,35627,97,0.2725561268931411
".Lackawanna County, Pennsylvania",215918,215539,216043,215750,216123,584,0.2704730499541493
".Amherst County, Virginia",31310,31312,31385,31472,31396,84,0.26828489300542957
".Champaign County, Ohio",38712,38743,38794,38743,38845,102,0.2634841909485431
".Trempealeau County, Wisconsin",30763,30818,30723,30891,30899,81,0.26330331892208175
".Clay County, Nebraska",6099,6100,6039,6049,6116,16,0.26233808821118215
".Middlesex County, New Jersey",863202,861408,862364,861094,863623,2215,0.25660274188428667
".Becker County, Minnesota",35172,35193,35336,35363,35283,90,0.255885363357216
".Doniphan County, Kansas",7509,7474,7456,7475,7493,19,0.253029697696098
".Laramie County, Wyoming",100512,100730,100827,100781,100984,254,0.25270614453995544
".Scotland County, North Carolina",34177,34290,34285,34350,34376,86,0.2516312139743102
".Val Verde County, Texas",47585,47605,47533,47617,47720,115,0.24167279604917516
".Brown County, Ohio",43673,43673,43696,43700,43777,104,0.23813340049916423
".Livingston County, Kentucky",8888,8871,8980,8968,8892,21,0.23627362736273627
".Marion County, Alabama",29340,29176,29001,29182,29244,68,0.2317655078391275
".Hanson County, South Dakota",3461,3463,3510,3479,3471,8,0.23114706732158338
".Windham County, Vermont",45915,45860,46150,45899,45966,106,0.23086137427855818
".Meeker County, Minnesota",23404,23437,23403,23526,23490,53,0.22645701589471884
".Renville County, North Dakota",2283,2274,2265,2250,2279,5,0.2190100744634253
".Wayne County, Pennsylvania",51149,51151,51188,51084,51262,111,0.21701304033314434
".St. Louis County, Minnesota",200233,200083,199521,199558,200514,431,0.21524923464164247
".Ottawa County, Oklahoma",30284,30222,30380,30329,30287,65,0.2146347906485273
".Ray County, Missouri",23161,23133,23089,23121,23182,49,0.21156254047752687
".Titus County, Texas",31241,31291,31260,31237,31357,66,0.21126084312281934
".Page County, Virginia",23709,23691,23825,23777,23741,50,0.21089037918090178
".Wilson County, North Carolina",78789,78804,78241,78306,78970,166,0.21068930942136593
".Wayne County, Kentucky",19554,19539,19535,19634,19580,41,0.20967576966349596
".Carroll County, Ohio",26716,26702,26700,26686,26758,56,0.20961221739781402
".Kandiyohi County, Minnesota",43726,43722,43809,43771,43813,91,0.2081141654850661
".Sauk County, Wisconsin",65766,65784,65702,65770,65920,136,0.20679378402213908
".Barron County, Wisconsin",46726,46737,46709,46715,46833,96,0.20545306681504943
".Seminole County, Oklahoma",23560,23517,23542,23464,23565,48,0.20373514431239387
".Vernon County, Missouri",19709,19670,19588,19599,19710,40,0.20295296565021057
".Graham County, North Carolina",8028,8036,8008,8032,8052,16,0.1993024414549078
".Matagorda County, Texas",36254,36287,36339,36122,36359,72,0.19859877530755227
".Grant County, South Dakota",7561,7538,7552,7486,7553,15,0.19838645681788122
".Piatt County, Illinois",16676,16681,16757,16675,16714,33,0.1978891820580475
".Polk County, Nebraska",5215,5218,5191,5240,5228,10,0.19175455417066153
".Dodge County, Nebraska",37171,37116,37128,37045,37187,71,0.19100912001291329
".Pinellas County, Florida",959111,959793,959583,961792,961596,1803,0.18798658340901103
".Pulaski County, Arkansas",399125,399274,398108,399387,400009,735,0.1841528343250861
".Lyon County, Kansas",32178,32113,32028,32031,32172,59,0.183355087326745
".Tripp County, South Dakota",5629,5611,5580,5579,5621,10,0.17765144785930007
".Chariton County, Missouri",7411,7386,7361,7395,7399,13,0.17541492376197543
".Scott County, Arkansas",9838,9834,9795,9796,9851,17,0.17279934946127262
".Marshall County, Kentucky",31664,31691,31829,31790,31744,53,0.16738251642243557
".Clackamas County, Oregon",421398,422468,423804,423118,423173,705,0.16730027195193142
".Cass County, Michigan",51597,51559,51527,51477,51642,83,0.1608620656239704
".Benton County, Indiana",8717,8715,8686,8672,8729,14,0.16060571297464724
".Kalamazoo County, Michigan",261677,261796,260523,260892,262215,419,0.16012106528277226
".Calhoun County, Alabama",116441,116243,115678,115780,116429,186,0.1597375494885822
".Washington County, Rhode Island",129845,129776,130851,130256,129982,206,0.1586506989102391
".Lincoln County, Nevada",4505,4445,4392,4440,4452,7,0.15538290788013318
".Jennings County, Indiana",27611,27580,27513,27484,27622,42,0.1521132881822462
".Lawrence County, Indiana",45015,45016,45066,45231,45084,68,0.15106075752526935
".Winona County, Minnesota",49666,49647,49788,49469,49721,74,0.14899528852736277
".Wilkes County, North Carolina",65973,65916,65826,65791,66013,97,0.1470298455428736
".Richland County, North Dakota",16533,16534,16557,16574,16558,24,0.14516421702050444
".Douglas County, South Dakota",2833,2834,2811,2787,2838,4,0.1411930815390046
".Defiance County, Ohio",38279,38262,38170,38128,38315,53,0.13845711747955797
".Jackson County, Arkansas",16765,16761,16781,16654,16784,23,0.13719057560393677
".Los Alamos County, New Mexico",19420,19418,19390,19273,19444,26,0.13388259526261587
".Andrew County, Missouri",18132,18103,18015,18016,18127,24,0.13236267372600927
".Jackson County, Missouri",717216,717615,717875,716218,718560,945,0.13175946995047516
".Swisher County, Texas",6972,6946,7007,6959,6955,9,0.12908777969018934
".Day County, South Dakota",5453,5444,5426,5475,5451,7,0.12836970474967907
".Monroe County, Missouri",8662,8687,8701,8635,8698,11,0.1269914569383514
".Lake County, South Dakota",11067,11017,10864,10940,11031,14,0.1265022137887413
".Surry County, North Carolina",71367,71373,71257,71482,71462,89,0.12470749786315805
".Clay County, Indiana",26462,26427,26394,26410,26460,33,0.12470712720126975
".Franklin County, Ohio",1323810,1324441,1317346,1321730,1326063,1622,0.12252513578232525
".Southampton County, Virginia",18000,17953,18024,17899,17975,22,0.12222222222222222
".Arapahoe County, Colorado",655075,655272,656855,656269,656061,789,0.12044422394382323
".Burt County, Nebraska",6724,6719,6709,6770,6727,8,0.1189767995240928
".Plymouth County, Iowa",25699,25692,25731,25722,25722,30,0.11673605976886262
".Edgecombe County, North Carolina",48898,48775,48333,48389,48832,57,0.11656918483373555
".Ontario County, New York",112485,112363,112661,112481,112494,131,0.11645997244076989
".Marion County, Oregon",345910,346350,347851,346719,346741,391,0.11303518256193808
".Bacon County, Georgia",11142,11112,11068,11173,11124,12,0.10770059235325795
".Owen County, Kentucky",11267,11301,11298,11294,11313,12,0.10650572468270171
".Roanoke County, Virginia",96931,96923,96671,96756,97026,103,0.10626115484210419
".Sullivan County, Pennsylvania",5838,5828,5859,5845,5834,6,0.10277492291880781
".Starr County, Texas",65921,65867,65858,65653,65934,67,0.10163680769405803
".Greenwood County, South Carolina",69349,69390,69126,69223,69460,70,0.10093873019077419
".Steele County, Minnesota",37406,37384,37427,37429,37421,37,0.09891461262899
".Providence County, Rhode Island",660728,659963,658782,657424,660615,652,0.09867903282439974
".Franklin County, Kentucky",51540,51594,51714,51548,51644,50,0.09701202949165696
".Monroe County, Michigan",154802,154896,155534,155235,155045,149,0.09625198640844433
".Kay County, Oklahoma",43690,43599,43715,43738,43641,42,0.09613183794918746
".Waseca County, Minnesota",18963,18963,19002,18914,18981,18,0.09492168960607499
".Colfax County, Nebraska",10580,10557,10477,10453,10566,9,0.08506616257088848
".Hardy County, West Virginia",14295,14239,14143,14168,14251,12,0.08394543546694648
".McLeod County, Minnesota",36771,36755,36815,36734,36785,30,0.08158603247124092
".Washington County, Iowa",22566,22542,22522,22542,22560,18,0.07976601967561818
".Richland County, Ohio",124927,124966,125341,125261,125064,98,0.07844581235441497
".Hancock County, Mississippi",46048,46123,46005,46007,46159,36,0.0781792911744267
".Pushmataha County, Oklahoma",10811,10792,10767,10709,10800,8,0.0739987050226621
".Suffolk County, New York",1525894,1522064,1533815,1527974,1523170,1106,0.07248209901867364
".Ringgold County, Iowa",4660,4639,4632,4688,4642,3,0.06437768240343347
".Vermilion Parish, Louisiana",57006,56956,56874,56953,56992,36,0.06315124723713293
".Delaware County, Pennsylvania",576836,576356,576892,575873,576720,364,0.0631028576579825
".Alpena County, Michigan",28912,28886,28939,28833,28904,18,0.06225788599889319
".Lincoln County, Arkansas",12936,12890,13168,12910,12898,8,0.06184291898577613
".St. Joseph County, Indiana",272916,272682,272286,272282,272848,166,0.060824576060033116
".Johnson County, Illinois",13304,13318,13472,13391,13326,8,0.06013229104028864
".Hamilton County, New York",5105,5079,5122,5121,5082,3,0.058765915768854066
".Leake County, Mississippi",21272,21246,21260,21203,21258,12,0.056412185031966905
".Cass County, Iowa",13134,13123,13089,13137,13130,7,0.05329678696512867
".Henry County, Indiana",48910,48903,49024,48815,48929,26,0.05315886321815579
".Vermillion County, Indiana",15443,15409,15435,15433,15417,8,0.051803406073949364
".Daviess County, Kentucky",103324,103405,103089,103189,103458,53,0.05129495567341567
".Nuckolls County, Nebraska",4097,4093,4071,4069,4095,2,0.0488162069807176
".Douglas County, Nevada",49482,49525,49999,49662,49545,20,0.040418738126995674
".Ware County, Georgia",36247,36229,35545,35597,36243,14,0.038623886114712944
".Woodbury County, Iowa",105939,105912,105749,105558,105951,39,0.03681363803698355
".Hill County, Montana",16311,16271,16220,16118,16276,5,0.03065415976948072
".Galax city, Virginia",6725,6715,6653,6702,6717,2,0.029739776951672865
".Emmet County, Michigan",34111,34113,34297,34215,34123,10,0.029316056404092523
".Falls Church city, Virginia",14661,14681,14516,14489,14685,4,0.02728326853557056
".Lyman County, South Dakota",3717,3704,3763,3705,3705,1,0.026903416733925208
".Sumner County, Kansas",22376,22328,22327,22359,22334,6,0.026814444047193423
".Grayson County, Virginia",15336,15281,15344,15325,15285,4,0.02608242044861763
".Forrest County, Mississippi",78162,78189,77869,77976,78208,19,0.024308487500319848
".Shiawassee County, Michigan",68095,68010,67991,67967,68025,15,0.022028049049122547
".Jefferson County, Kansas",18360,18323,18429,18354,18327,4,0.021786492374727667
".Vigo County, Indiana",106158,106130,106116,106082,106153,23,0.021665818873754218
".Allamakee County, Iowa",14064,14071,13968,14018,14074,3,0.021331058020477817
".Geauga County, Ohio",95433,95387,95708,95491,95407,20,0.0209571112717823
".DeKalb County, Illinois",100422,100269,100482,100223,100288,19,0.01892015693772281
".Houston County, Texas",22072,22062,21962,21943,22066,4,0.01812250815512867
".Lyon County, Minnesota",25520,25423,25492,25433,25427,4,0.015673981191222573
".Fayette County, Indiana",23398,23359,23381,23389,23362,3,0.012821608684502949
".Monroe County, Illinois",34953,34953,35004,35001,34957,4,0.01144393900380511
".Manassas city, Virginia",42773,42692,42764,42673,42696,4,0.009351693825544152
".Baylor County, Texas",3467,3463,3458,3462,3463,0,0.0
".Casey County, Kentucky",15939,15918,15940,15911,15918,0,0.0
".Essex County, Virginia",10600,10598,10571,10630,10598,0,0.0
".Dawson County, Nebraska",24109,24085,23934,23905,24085,0,0.0
".Wheeler County, Nebraska",772,775,785,782,775,0,0.0
".Mower County, Minnesota",40033,40059,40219,40050,40058,-1,-0.002497939200159868
".Champaign County, Illinois",205873,205654,206605,206169,205644,-10,-0.0048573635202284905
".Monmouth County, New Jersey",643612,642836,646517,644228,642799,-37,-0.00574880518076108
".Anderson County, Kansas",7834,7839,7807,7798,7838,-1,-0.012764871074802146
".Ingham County, Michigan",284907,284675,271224,283477,284637,-38,-0.013337685630749682
".Monroe County, West Virginia",12378,12384,12388,12322,12382,-2,-0.016157699143641947
".Bucks County, Pennsylvania",646528,646173,647397,645557,645984,-189,-0.02923307265887943
".Holt County, Nebraska",10120,10096,10052,10013,10093,-3,-0.02964426877470356
".Yakima County, Washington",256738,256733,256719,257019,256643,-90,-0.03505519245300657
".Snyder County, Pennsylvania",39734,39733,39734,39506,39717,-16,-0.04026778074193386
".Jackson County, Indiana",46436,46479,46224,46230,46460,-19,-0.04091653027823241
".Henrico County, Virginia",334931,334905,334422,334553,334760,-145,-0.043292499052043555
".Alexander County, North Carolina",36444,36489,36364,36316,36473,-16,-0.043902974426517395
".Lewis County, New York",26587,26560,26722,26595,26548,-12,-0.04513484033550231
".Winnebago County, Wisconsin",171735,171815,170580,170688,171735,-80,-0.04658339884123795
".Mathews County, Virginia",8533,8518,8543,8450,8514,-4,-0.046876831126215865
".Walthall County, Mississippi",13884,13871,13830,13824,13863,-8,-0.05762028233938346
".Noble County, Indiana",47462,47460,47392,47234,47430,-30,-0.06320846150604695
".Indiana County, Pennsylvania",83233,83151,83201,83064,83094,-57,-0.06848245287325941
".Umatilla County, Oregon",80083,80108,80153,80261,80053,-55,-0.06867874580123122
".Manitowoc County, Wisconsin",81360,81387,81506,81198,81331,-56,-0.06882989183874139
".Lincoln County, Wisconsin",28416,28426,28457,28355,28405,-21,-0.07390202702702703
".Mineral County, West Virginia",26932,26889,26897,26902,26867,-22,-0.08168721223822963
".Story County, Iowa",98533,98649,99679,98257,98566,-83,-0.08423573828057605
".Nemaha County, Nebraska",7073,7082,7004,7036,7076,-6,-0.08482963381874735
".San Luis Obispo County, California",282443,281884,279464,282046,281639,-245,-0.08674316587771692
".Wilcox County, Georgia",8764,8787,8737,8751,8779,-8,-0.09128251939753537
".Caldwell County, North Carolina",80678,80652,80547,80347,80574,-78,-0.09668063164679343
".Salt Lake County, Utah",1185230,1186983,1186312,1186569,1185813,-1170,-0.09871501733840689
".Nelson County, North Dakota",3014,2994,3049,2999,2991,-3,-0.09953550099535502
".Gage County, Nebraska",21707,21656,21633,21564,21634,-22,-0.10134979499700557
".Menard County, Texas",1963,1960,1968,1979,1958,-2,-0.10188487009679062
".Tattnall County, Georgia",24284,24321,24092,23988,24296,-25,-0.1029484434195355
".St. Joseph County, Michigan",60942,60941,60844,60778,60878,-63,-0.10337698139214334
".Perry County, Missouri",18954,18970,18972,18878,18950,-20,-0.10551862403714254
".Kings County, California",152486,152844,152775,152987,152682,-162,-0.10623926130923496
".Monroe County, Kentucky",11336,11319,11260,11353,11306,-13,-0.11467889908256881
".Centre County, Pennsylvania",158163,157979,157984,157533,157795,-184,-0.11633567901468739
".Weston County, Wyoming",6838,6816,6746,6858,6808,-8,-0.11699327288680901
".Washington County, Indiana",28168,28238,28138,28171,28205,-33,-0.11715421755183186
".LaMoure County, North Dakota",4091,4101,4079,4076,4096,-5,-0.12221950623319482
".Franklin County, Massachusetts",71028,70923,70991,70995,70836,-87,-0.12248690657205609
".Logan County, Ohio",46153,46116,46158,46062,46057,-59,-0.12783567698741144
".King County, Washington",2269697,2274282,2252980,2265311,2271380,-2902,-0.12785847626357175
".Hampton city, Virginia",137157,137280,137760,137858,137098,-182,-0.13269464919763482
".Jefferson County, Indiana",33143,33100,33117,32936,33056,-44,-0.1327580484566877
".Talbot County, Georgia",5735,5726,5755,5757,5718,-8,-0.13949433304272016
".Toombs County, Georgia",27026,27078,26847,26813,27040,-38,-0.14060534300303412
".Sacramento County, California",1585045,1586566,1588810,1584380,1584288,-2278,-0.14371831714556998
".Dallas County, Texas",2611481,2610112,2588235,2601993,2606358,-3754,-0.14374984922348658
".Denver County, Colorado",715524,717606,711467,713453,716577,-1029,-0.1438106897881832
".Clatsop County, Oregon",41076,41162,41932,41652,41102,-60,-0.1460706982179375
".LaSalle Parish, Louisiana",14797,14823,14842,14821,14800,-23,-0.15543691288774752
".Tillamook County, Oregon",27386,27461,27808,27521,27417,-44,-0.1606660337398671
".Oakland County, Michigan",1274402,1272493,1272630,1271025,1270426,-2067,-0.16219371909334732
".Union County, New Jersey",575363,573660,572833,570417,572726,-934,-0.16233230152095285
".Brooks County, Georgia",16301,16272,16276,16284,16245,-27,-0.16563401018342433
".Taos County, New Mexico",34490,34463,34685,34590,34405,-58,-0.16816468541606264
".Bollinger County, Missouri",10574,10562,10586,10531,10544,-18,-0.17022886324947986
".Davison County, South Dakota",19953,19956,19899,19907,19922,-34,-0.17040044103643562
".Jackson County, Ohio",32646,32662,32539,32611,32606,-56,-0.17153709489677144
".Monroe County, Indiana",139711,139585,140176,139621,139342,-243,-0.17393047075749227
".Chester County, South Carolina",32294,32284,32148,31993,32226,-58,-0.17959992568278937
".Faribault County, Minnesota",13919,13898,13906,13930,13873,-25,-0.17961060421007258
".Atkinson County, Georgia",8286,8308,8348,8160,8293,-15,-0.18102824040550325
".Graves County, Kentucky",36654,36528,36673,36493,36461,-67,-0.18279041850821193
".Ellsworth County, Kansas",6382,6369,6324,6383,6357,-12,-0.1880288310874334
".Muskingum County, Ohio",86421,86468,86577,86114,86305,-163,-0.1886115643188577
".Scott County, Iowa",174671,174609,174225,173751,174270,-339,-0.19407915452479232
".Maverick County, Texas",57884,57875,57683,57628,57762,-113,-0.19521802225139936
".DeKalb County, Georgia",764425,764489,759113,761779,762992,-1497,-0.19583346960133433
".Douglas County, Wisconsin",44295,44351,44055,44226,44264,-87,-0.19641043007111414
".Wallace County, Kansas",1512,1512,1513,1493,1509,-3,-0.1984126984126984
".Hockley County, Texas",21542,21504,21265,21278,21460,-44,-0.20425215857394857
".Marshall County, Iowa",40106,40096,39913,39821,40014,-82,-0.20445818580760983
".Etowah County, Alabama",103434,103453,103010,102903,103241,-212,-0.20496161803662238
".Fond du Lac County, Wisconsin",104160,104169,104116,103812,103948,-221,-0.21217357910906295
".Clinton County, Ohio",42022,42028,42115,41890,41938,-90,-0.21417352815192042
".Delta County, Michigan",36903,36870,36825,36781,36790,-80,-0.2167845432620654
".Schley County, Georgia",4548,4536,4486,4497,4526,-10,-0.21987686895338612
".Dubois County, Indiana",43631,43642,43565,43492,43546,-96,-0.2200270449909468
".Nevada County, California",102237,102265,103517,102401,102037,-228,-0.2230112385926817
".Rusk County, Wisconsin",14186,14175,14085,14099,14143,-32,-0.22557451008036095
".Green County, Wisconsin",37088,37035,37066,36885,36951,-84,-0.22648835202761
".Montgomery County, Maryland",1062065,1060904,1056193,1053067,1058474,-2430,-0.22879955558275625
".Macon County, Missouri",15210,15196,15178,15076,15161,-35,-0.23011176857330704
".Kane County, Illinois",516516,516181,516292,514139,514982,-1199,-0.2321322088763949
".Ben Hill County, Georgia",17194,17168,17128,17057,17128,-40,-0.23263929277654993
".Montgomery County, New York",49527,49485,49482,49333,49368,-117,-0.23623478102852988
".Nelson County, Virginia",14772,14740,14838,14747,14705,-35,-0.23693474140265366
".Beaver County, Oklahoma",5053,5030,4994,5019,5018,-12,-0.23748268355432417
".Mercer County, Ohio",42539,42542,42392,42424,42439,-103,-0.24213075060532688
".Coal County, Oklahoma",5265,5279,5304,5291,5266,-13,-0.24691358024691357
".Maries County, Missouri",8428,8451,8417,8432,8430,-21,-0.24916943521594684
".Sandusky County, Ohio",58886,58856,58741,58567,58709,-147,-0.24963488774921036
".Sheboygan County, Wisconsin",118032,118053,117687,117661,117752,-301,-0.2550155889928155
".Petersburg city, Virginia",33463,33396,33411,33462,33309,-87,-0.2599886441741625
".Preston County, West Virginia",34213,34188,34304,34222,34099,-89,-0.26013503638967644
".Pike County, Ohio",27090,27072,27094,27012,27001,-71,-0.26208933185677374
".Middlesex County, Massachusetts",1632028,1628235,1617262,1616794,1623952,-4283,-0.26243422294225344
".Boone County, Illinois",53451,53343,53173,53068,53202,-141,-0.26379300667901445
".Sullivan County, Indiana",20811,20812,20777,20671,20757,-55,-0.2642833117101533
".Lenoir County, North Carolina",55123,55046,54683,54499,54895,-151,-0.2739328411008109
".Thomas County, Georgia",45791,45775,45818,45551,45649,-126,-0.2751632416850473
".Sussex County, Virginia",10827,10787,10815,10640,10757,-30,-0.2770850651149903
".Dawes County, Nebraska",8200,8156,8149,8252,8133,-23,-0.28048780487804875
".Elkhart County, Indiana",207046,206991,207054,206873,206409,-582,-0.28109695430001064
".Perkins County, South Dakota",2842,2842,2825,2809,2834,-8,-0.28149190710767064
".Decatur County, Indiana",26475,26474,26353,26454,26399,-75,-0.28328611898017
".Clark County, Missouri",6638,6660,6735,6715,6641,-19,-0.2862307924073516
".Marshall County, Illinois",11752,11717,11668,11671,11683,-34,-0.2893124574540504
".Butler County, Missouri",42135,42070,42170,42166,41948,-122,-0.28954550848463273
".Vanderburgh County, Indiana",180128,180336,180165,179563,179810,-526,-0.29201456741872445
".Yellow Medicine County, Minnesota",9523,9495,9439,9484,9467,-28,-0.2940249921243306
".McLean County, Illinois",170956,170949,171109,170918,170441,-508,-0.29715248368001124
".Hancock County, Ohio",74920,74928,74764,74774,74704,-224,-0.2989855846235985
".Langlade County, Wisconsin",19491,19463,19479,19502,19404,-59,-0.30270381201580215
".McPherson County, Kansas",30221,30184,30164,30063,30091,-93,-0.3077330333212005
".Imperial County, California",179713,179612,179138,178940,179057,-555,-0.30882573881689135
".Nueces County, Texas",353175,353398,353292,351590,352289,-1109,-0.3140086359453529
".Clinton County, Illinois",36893,36901,36882,36937,36785,-116,-0.31442279023120917
".Jackson County, Oklahoma",24794,24747,24744,24659,24669,-78,-0.31459224005807856
".Hillsdale County, Michigan",45754,45731,45625,45735,45587,-144,-0.3147265812825108
".St. Clair County, Michigan",160379,160380,160205,159668,159874,-506,-0.3155026530904919
".Bennington County, Vermont",37342,37301,37431,37343,37183,-118,-0.3159980718761716
".Cass County, Indiana",37859,37786,37558,37537,37666,-120,-0.3169655828204654
".Johnston County, Oklahoma",10283,10249,10332,10346,10216,-33,-0.3209180200330643
".Monroe County, Wisconsin",46270,46300,46083,45894,46151,-149,-0.322022909012319
".Sanilac County, Michigan",40612,40499,40528,40482,40368,-131,-0.32256475918447747
".Crittenden County, Kentucky",8988,9003,8944,8991,8974,-29,-0.32265242545616374
".Echols County, Georgia",3704,3721,3698,3686,3709,-12,-0.32397408207343414
".Dewey County, South Dakota",5243,5225,5223,5142,5208,-17,-0.32424184627121877
".Eaton County, Michigan",109165,109175,108908,108854,108820,-355,-0.3251958045160995
".Miami-Dade County, Florida",2701776,2695685,2669748,2673056,2686867,-8818,-0.32637790845725184
".Stanislaus County, California",552882,553257,552723,551226,551430,-1827,-0.33045025882557216
".Bibb County, Georgia",157347,157035,155980,156126,156512,-523,-0.3323863816914209
".Roseau County, Minnesota",15330,15303,15274,15334,15252,-51,-0.33268101761252444
".Woodford County, Illinois",38465,38413,38220,38177,38285,-128,-0.3327700506954374
".Anderson County, Texas",57921,57930,58302,57227,57736,-194,-0.3349389685951555
".Scott County, Missouri",38054,38020,37886,37868,37889,-131,-0.34424764807904557
".Escambia County, Alabama",36768,36685,36660,36636,36558,-127,-0.34540905134899913
".Grant County, Oregon",7232,7240,7288,7225,7215,-25,-0.3456858407079646
".Moore County, Texas",21358,21264,21136,21094,21190,-74,-0.346474388987733
".Warren County, New York",65737,65609,65735,65427,65380,-229,-0.34835785022133653
".Wood County, Wisconsin",74215,74199,74005,73778,73939,-260,-0.3503334905342586
".Rutland County, Vermont",60574,60484,60728,60353,60271,-213,-0.35163601545217416
".Evans County, Georgia",10773,10792,10697,10659,10754,-38,-0.3527336860670194
".Wayne County, Ohio",116900,116923,116175,116552,116510,-413,-0.3532934131736527
".Maui County, Hawaii",164756,164768,164797,164359,164183,-585,-0.3550705285391731
".Wilkes County, Georgia",9562,9552,9489,9565,9518,-34,-0.3555741476678519
".La Crosse County, Wisconsin",120779,120921,119331,120252,120486,-435,-0.360161948683132
".Lincoln County, Mississippi",34907,34828,34939,34764,34702,-126,-0.36095911994728846
".Pulaski County, Missouri",53960,54010,53815,53810,53812,-198,-0.36693847294292065
".Clayton County, Iowa",17047,17033,17053,17057,16969,-64,-0.3754326274417786
".Lake County, Ohio",232521,232516,232222,231736,231640,-876,-0.3767401654044151
".Washington County, Oregon",600369,601130,602453,600086,598865,-2265,-0.37726798019218183
".Clayton County, Georgia",299403,299439,299210,298399,298300,-1139,-0.3804237098492667
".Harlan County, Nebraska",3076,3057,3097,3032,3045,-12,-0.3901170351105332
".Gasconade County, Missouri",14794,14763,14780,14772,14705,-58,-0.3920508314181425
".Woods County, Oklahoma",8622,8598,8623,8602,8564,-34,-0.3943400603108328
".Hamilton County, Ohio",830628,830377,827430,824721,827058,-3319,-0.39957718738111403
".Hancock County, Georgia",8736,8711,8677,8417,8676,-35,-0.4006410256410256
".Lancaster County, Virginia",10923,10903,10935,10806,10859,-44,-0.4028197381671702
".Boone County, Iowa",26709,26698,26761,26579,26590,-108,-0.4043580815455464
".Miller County, Arkansas",42599,42588,42494,42608,42415,-173,-0.4061128195497547
".Wayne County, New York",91286,91202,91149,90958,90829,-373,-0.40860591985627587
".Jenkins County, Georgia",8676,8663,8764,8655,8627,-36,-0.4149377593360996
".Yalobusha County, Mississippi",12482,12438,12439,12413,12386,-52,-0.41659990386156065
".Dubuque County, Iowa",99275,99308,98854,98715,98887,-421,-0.4240745404180307
".Knox County, Missouri",3743,3739,3785,3777,3723,-16,-0.42746460058776387
".Roberts County, South Dakota",10271,10250,10172,10139,10206,-44,-0.42839061435108555
".Hutchinson County, South Dakota",7426,7426,7377,7351,7394,-32,-0.43091839482897926
".Searcy County, Arkansas",7828,7840,7893,7906,7806,-34,-0.43433827286663257
".Black Hawk County, Iowa",131143,131044,130576,130052,130471,-573,-0.4369276286191409
".Cherokee County, Iowa",11657,11656,11535,11490,11605,-51,-0.4375053615853135
".Gibson County, Indiana",33008,33049,32965,33002,32904,-145,-0.4392874454677654
".Natrona County, Wyoming",79966,80299,79635,79523,79941,-358,-0.44769026836405473
".Seminole County, Georgia",9152,9133,9162,9144,9092,-41,-0.4479895104895105
".Pulaski County, Virginia",33799,33807,33816,33683,33655,-152,-0.44971744726175333
".Tioga County, Pennsylvania",41053,41025,41308,40967,40840,-185,-0.45063698146298686
".Wapello County, Iowa",35436,35326,35295,35081,35166,-160,-0.4515182300485382
".Mercer County, North Dakota",8353,8347,8339,8327,8309,-38,-0.4549263737579313
".Bradford County, Pennsylvania",59968,59968,60137,59854,59695,-273,-0.45524279615795094
".Dade County, Georgia",16249,16239,16221,16090,16165,-74,-0.455412640777894
".Cape May County, New Jersey",95262,95044,95706,95405,94610,-434,-0.45558564800235146
".Accomack County, Virginia",33418,33392,33410,33223,33239,-153,-0.4578370937817942
".Bedford County, Pennsylvania",47568,47568,47487,47421,47350,-218,-0.45829128826101584
".Grant County, Indiana",66680,66507,66188,65993,66200,-307,-0.4604079184163167
".Brunswick County, Virginia",15846,15822,15959,15831,15749,-73,-0.46068408431149815
".Bleckley County, Georgia",12585,12523,12270,12279,12465,-58,-0.46086611044894715
".Patrick County, Virginia",17610,17591,17650,17601,17509,-82,-0.46564452015900054
".Mifflin County, Pennsylvania",46134,46137,46171,45984,45922,-215,-0.4660337278363029
".Fillmore County, Nebraska",5559,5574,5559,5541,5548,-26,-0.46771001978773163
".Jackson County, West Virginia",27792,27723,27781,27667,27593,-130,-0.46776050662061025
".Prince George County, Virginia",43010,43073,42962,43021,42871,-202,-0.4696582190188328
".Crenshaw County, Alabama",13193,13163,13069,13048,13101,-62,-0.46994618358220264
".Walworth County, South Dakota",5318,5294,5260,5286,5269,-25,-0.4701015419330576
".Washington County, Kansas",5530,5530,5525,5493,5504,-26,-0.47016274864376134
".Lake County, California",68160,68199,68645,68172,67878,-321,-0.47095070422535207
".Crawford County, Kansas",38971,38948,39028,39145,38764,-184,-0.4721459546842524
".Garland County, Arkansas",100173,100258,100393,99982,99784,-474,-0.4731813961846006
".Josephine County, Oregon",88088,88238,88637,87800,87821,-417,-0.47339024611751884
".Greer County, Oklahoma",5491,5492,5480,5546,5466,-26,-0.47350209433618645
".Ellis County, Kansas",28935,28948,28850,28840,28810,-138,-0.4769310523587351
".Beaufort County, North Carolina",44659,44694,44462,44400,44481,-213,-0.47694753577106513
".Stark County, Ohio",374864,374522,373792,372785,372716,-1806,-0.4817747236331043
".Racine County, Wisconsin",197735,197568,196505,195961,196613,-955,-0.4829696310718891
".Brewster County, Texas",9545,9560,9473,9344,9513,-47,-0.49240440020953374
".Coconino County, Arizona",145104,145192,142897,144223,144472,-720,-0.49619583195501155
".Richland County, Wisconsin",17310,17283,17199,17128,17197,-86,-0.4968226458694396
".Wyoming County, Pennsylvania",26072,26032,26106,26024,25902,-130,-0.49861920834611845
".Bladen County, North Carolina",29619,29632,29544,29391,29484,-148,-0.4996792599345015
".LaPorte County, Indiana",112404,112270,112513,111822,111706,-564,-0.5017615031493541
".Jackson County, Michigan",160370,160231,160162,159758,159424,-807,-0.5032113238136808
".Huron County, Ohio",58571,58495,58412,58219,58199,-296,-0.505369551484523
".Ohio County, Kentucky",23771,23747,23744,23496,23626,-121,-0.5090236001850995
".Knox County, Indiana",36289,36256,35976,35876,36070,-186,-0.5125520130066962
".Teller County, Colorado",24707,24744,24945,24860,24617,-127,-0.5140243655644149
".Runnels County, Texas",9898,9919,9892,9884,9868,-51,-0.5152556071933724
".Clark County, Arkansas",21445,21385,21244,21276,21274,-111,-0.5176031709023082
".Nottoway County, Virginia",15649,15647,15574,15555,15566,-81,-0.5176049587833088
".Fairbanks North Star Borough, Alaska",95660,95337,95593,95202,94840,-497,-0.5195484005854066
".Davidson County, Tennessee",715878,716059,700860,707351,712334,-3725,-0.5203400579428338
".Lake County, Minnesota",10903,10912,11004,10912,10855,-57,-0.5227918921397781
".Pottawattamie County, Iowa",93666,93669,93410,93065,93179,-490,-0.5231353959814661
".Marion County, Missouri",28529,28486,28556,28489,28336,-150,-0.5257807844649304
".Wayne County, Mississippi",19778,19808,19669,19583,19703,-105,-0.5308929113156032
".Ashland County, Ohio",52437,52470,52183,52024,52190,-280,-0.5339741022560406
".Henry County, Ohio",27663,27668,27560,27526,27520,-148,-0.5350106640639121
".Richmond County, Georgia",206603,206524,205274,206344,205414,-1110,-0.5372622856396083
".Shawnee County, Kansas",178907,178709,178403,177537,177746,-963,-0.5382684858613693
".Talladega County, Alabama",82149,81575,80734,80748,81132,-443,-0.5392640202558765
".Jefferson County, Wisconsin",86161,86208,85782,85725,85743,-465,-0.539687329534244
".Putnam County, Ohio",34435,34385,34341,34330,34199,-186,-0.540148105125599
".Fulton County, Indiana",20479,20469,20412,20368,20358,-111,-0.5420186532545535
".Fayette County, Ohio",28948,28975,28934,28832,28817,-158,-0.5458062733176731
".Willacy County, Texas",20164,20148,20292,20254,20037,-111,-0.5504860146796271
".Howard County, Missouri",10155,10157,10145,10179,10101,-56,-0.551452486459872
".Lane County, Oregon",382983,383308,384121,382181,381181,-2127,-0.5553771316220303
".Jim Wells County, Texas",38893,38879,38893,38729,38662,-217,-0.557941017663847
".Paulding County, Ohio",18806,18811,18902,18762,18706,-105,-0.5583324470913538
".Luna County, New Mexico",25426,25458,25471,25693,25316,-142,-0.5584834421458349
".Vance County, North Carolina",42569,42540,42101,42154,42301,-239,-0.5614414245107943
".Linn County, Missouri",11875,11858,11842,11826,11791,-67,-0.5642105263157895
".Mineral County, Nevada",4553,4554,4617,4537,4528,-26,-0.5710520535910389
".Wayne County, Indiana",66541,66507,66435,66216,66127,-380,-0.5710764791632227
".Posey County, Indiana",25218,25185,25165,25098,25040,-145,-0.574986121024665
".Barbour County, West Virginia",15465,15467,15449,15391,15378,-89,-0.5754930488199159
".San Juan County, New Mexico",121666,121376,120996,120569,120675,-701,-0.5761675406440583
".Adair County, Missouri",25312,25268,25188,25151,25122,-146,-0.5768015170670038
".Lake County, Colorado",7432,7408,7395,7346,7365,-43,-0.5785791173304629
".Clinton County, Iowa",46459,46427,46483,46255,46158,-269,-0.579005144320799
".Jackson County, Iowa",19485,19455,19399,19346,19342,-113,-0.5799332820118039
".Macomb County, Michigan",881214,880238,877646,874235,875101,-5137,-0.5829457997716786
".Fairfax County, Virginia",1150294,1148627,1142203,1139309,1141878,-6749,-0.5867195690840776
".Grand Forks County, North Dakota",73181,73141,72586,72421,72708,-433,-0.5916836337300666
".Dyer County, Tennessee",36808,36716,36609,36440,36498,-218,-0.5922625516192133
".Webster County, Georgia",2348,2351,2362,2337,2337,-14,-0.596252129471891
".Grady County, Georgia",26236,26224,25850,25994,26066,-158,-0.6022259490776033
".Ector County, Texas",165170,165490,160758,161057,164494,-996,-0.6030150753768844
".Elk County, Kansas",2486,2482,2439,2448,2467,-15,-0.6033789219629927
".Bee County, Texas",31050,31038,30836,30992,30850,-188,-0.605475040257649
".Williamson County, Illinois",67152,67114,66883,66544,66706,-408,-0.6075768406004289
".Bottineau County, North Dakota",6383,6388,6448,6384,6349,-39,-0.6109979633401221
".Clarion County, Pennsylvania",37239,37199,37594,37227,36970,-229,-0.6149466956685196
".Reno County, Kansas",61883,61878,61499,61552,61497,-381,-0.615677972948952
".Susquehanna County, Pennsylvania",38434,38346,38417,38139,38109,-237,-0.6166415153249727
".Marion County, Mississippi",24439,24375,24304,24166,24224,-151,-0.6178648880887107
".Montgomery County, Ohio",537306,537119,536155,533474,533796,-3323,-0.6184557775271448
".De Witt County, Illinois",15520,15461,15403,15365,15365,-96,-0.6185567010309279
".Calhoun County, Michigan",134297,134200,133878,133424,133366,-834,-0.6210116383835826
".Isabella County, Michigan",64396,64518,64248,64366,64118,-400,-0.6211565935772408
".McCurtain County, Oklahoma",30821,30852,30824,30773,30660,-192,-0.6229518834560852
".Walker County, Alabama",65344,65138,64636,64438,64728,-410,-0.6274485798237023
".Linn County, Iowa",230296,230419,229445,228940,228972,-1447,-0.6283218119289957
".Pierce County, Nebraska",7319,7345,7319,7317,7299,-46,-0.6285011613608417
".Grant County, West Virginia",10976,10990,10992,10938,10921,-69,-0.6286443148688047
".Lee County, Mississippi",83351,83323,83008,82824,82799,-524,-0.6286667226547972
".Nassau County, New York",1395767,1390491,1391809,1385294,1381715,-8776,-0.6287582383019515
".Teton County, Wyoming",23323,23379,23605,23297,23232,-147,-0.6302791236118853
".Lake County, Illinois",714336,713281,712570,709899,708760,-4521,-0.6328954441607311
".Anson County, North Carolina",22054,22037,21905,21958,21897,-140,-0.6348054774644055
".Concho County, Texas",3302,3318,3348,3367,3297,-21,-0.6359781950333132
".Sierra County, New Mexico",11573,11562,11519,11474,11488,-74,-0.6394193381145771
".Custer County, Oklahoma",28523,28449,28175,28039,28266,-183,-0.6415874907969008
".Coosa County, Alabama",10378,10335,10314,10307,10268,-67,-0.6455964540373867
".Trumbull County, Ohio",202064,201681,201572,200726,200373,-1308,-0.6473196610974741
".Erie County, New York",954231,952342,952912,948423,946147,-6195,-0.6492138695976132
".Morris County, Kansas",5391,5369,5386,5400,5334,-35,-0.6492301984789464
".Hughes County, South Dakota",17769,17740,17760,17681,17624,-116,-0.652822331025944
".Craig County, Virginia",4892,4875,4886,4858,4843,-32,-0.6541291905151267
".Scotland County, Missouri",4717,4707,4674,4647,4676,-31,-0.6571973712105151
".Mobile County, Alabama",414809,414377,413383,411398,411640,-2737,-0.6598217492870212
".Washington County, Georgia",19994,19952,19758,19765,19820,-132,-0.6601980594178254
".Smith County, Mississippi",14208,14193,14191,14082,14099,-94,-0.6615990990990991
".Campbell County, Virginia",55699,55639,55344,55065,55270,-369,-0.662489452234331
".Caldwell County, Kentucky",12647,12635,12678,12608,12551,-84,-0.6641891357634221
".Ashtabula County, Ohio",97567,97495,97439,96960,96845,-650,-0.666208861602796
".Alfalfa County, Oklahoma",5703,5711,5695,5689,5673,-38,-0.6663159740487463
".Pratt County, Kansas",9153,9143,9168,9073,9082,-61,-0.6664481590735278
".Steele County, North Dakota",1795,1794,1806,1793,1782,-12,-0.6685236768802229
".Haines Borough, Alaska",2078,2084,2074,2070,2070,-14,-0.6737247353224254
".Harper County, Kansas",5490,5472,5355,5400,5435,-37,-0.6739526411657559
".Barnwell County, South Carolina",20590,20586,20594,20471,20447,-139,-0.6750849927149101
".Juneau County, Wisconsin",26716,26775,26763,26775,26594,-181,-0.6774966312322204
".Jasper County, Texas",32978,32919,32552,32495,32694,-225,-0.6822730305051853
".Douglas County, Illinois",19736,19764,19694,19667,19629,-135,-0.6840291852452371
".Ford County, Kansas",34288,34215,34186,33924,33980,-235,-0.6853709752683155
".Stutsman County, North Dakota",21587,21540,21579,21476,21392,-148,-0.6855978134988651
".Red Lake County, Minnesota",3934,3938,3945,3881,3911,-27,-0.6863243518047788
".Darlington County, South Carolina",62905,62848,62725,62436,62416,-432,-0.6867498609013591
".Martin County, Texas",5238,5252,5214,5228,5216,-36,-0.6872852233676976
".Neshoba County, Mississippi",29092,28991,28908,28804,28789,-202,-0.6943489619139283
".Livingston County, New York",61840,61590,61691,61340,61158,-432,-0.6985769728331177
".Pittsburg County, Oklahoma",43773,43788,43630,43476,43479,-309,-0.7059146048934275
".Cochise County, Arizona",125445,125527,126119,125487,124640,-887,-0.7070827852843875
".Clay County, Alabama",14237,14212,14170,14183,14111,-101,-0.70941911919646
".Ross County, Ohio",77078,77049,76500,76508,76501,-548,-0.7109681102260048
".Franklin County, Mississippi",7681,7665,7687,7611,7610,-55,-0.7160525973180575
".Simpson County, Mississippi",25957,25901,25702,25623,25715,-186,-0.7165697114458527
".Lincoln Parish, Louisiana",48401,48309,48110,47980,47962,-347,-0.7169273362120617
".McCracken County, Kentucky",67872,67917,67546,67366,67428,-489,-0.7204738330975955
".Scott County, Virginia",21569,21589,21476,21480,21433,-156,-0.7232602345959479
".Unicoi County, Tennessee",17925,17886,17631,17591,17756,-130,-0.7252440725244073
".Menominee County, Wisconsin",4251,4257,4297,4206,4226,-31,-0.7292401787814632
".Nicollet County, Minnesota",34449,34494,34348,34343,34242,-252,-0.7315161543150744
".Van Wert County, Ohio",28931,28916,28784,28804,28704,-212,-0.7327779890083301
".Taylor County, Florida",21799,21743,20807,21313,21582,-161,-0.7385659892655627
".Banner County, Nebraska",676,679,690,657,674,-5,-0.7396449704142012
".Columbus County, North Carolina",50629,50496,50020,50075,50121,-375,-0.7406822177013175
".Iron County, Missouri",9534,9511,9429,9413,9440,-71,-0.7447031676106566
".Mitchell County, Iowa",10570,10597,10563,10544,10518,-79,-0.7473982970671713
".Bourbon County, Kentucky",20246,20286,20224,20109,20134,-152,-0.7507655833251012
".Gratiot County, Michigan",41762,41683,41286,41104,41368,-315,-0.7542742205833054
".Columbia County, Wisconsin",58492,58533,58445,58228,58091,-442,-0.7556588935239007
".Summit County, Ohio",540429,539821,537436,535769,535733,-4088,-0.7564360905872927
".Jackson County, Minnesota",9994,9995,10005,9898,9919,-76,-0.7604562737642585
".Fulton County, Pennsylvania",14564,14579,14551,14554,14468,-111,-0.7621532546003845
".Owsley County, Kentucky",4053,4032,3974,3958,4001,-31,-0.76486553170491
".Fayette County, Kentucky",322564,322627,320519,320281,320154,-2473,-0.7666695601493037
".San Diego County, California",3298648,3295298,3274432,3277176,3269973,-25325,-0.7677387826770241
".Taylor County, Georgia",7814,7818,7769,7762,7758,-60,-0.7678525723061171
".Marion County, West Virginia",56216,56240,56053,55784,55807,-433,-0.7702433470897965
".Solano County, California",453491,452723,450653,448885,449218,-3505,-0.7728929570818385
".Sierra County, California",3231,3225,3294,3222,3200,-25,-0.773754255648406
".Wythe County, Virginia",28291,28324,28201,28115,28104,-220,-0.7776324626206214
".Bernalillo County, New Mexico",676452,676853,675286,672957,671586,-5267,-0.7786213951618149
".Humboldt County, Nevada",17284,17271,17632,17296,17136,-135,-0.7810691969451516
".Prince of Wales-Hyder Census Area, Alaska",5755,5741,5720,5650,5696,-45,-0.7819287576020852
".Colfax County, New Mexico",12384,12352,12346,12272,12255,-97,-0.7832687338501293
".Boyd County, Kentucky",48258,48206,47757,48059,47826,-380,-0.787434207799743
".Richmond County, New York",495752,494598,493547,491358,490687,-3911,-0.788902515774016
".Shelby County, Ohio",48229,48146,48023,47684,47765,-381,-0.7899811316842564
".Waupaca County, Wisconsin",51813,51798,51986,51510,51388,-410,-0.7913072008955281
".Republic County, Kansas",4669,4664,4688,4653,4627,-37,-0.7924609124009423
".Burke County, Georgia",24594,24635,24362,24434,24438,-197,-0.8010083760266731
".Haakon County, South Dakota",1872,1866,1835,1834,1851,-15,-0.8012820512820512
".Randolph County, Indiana",24508,24415,24409,24350,24216,-199,-0.8119797617104619
".Starke County, Indiana",23383,23396,23373,23203,23206,-190,-0.8125561305221742
".Decatur County, Georgia",29368,29326,29091,29019,29087,-239,-0.8138109506946336
".Crawford County, Indiana",10528,10524,10491,10517,10438,-86,-0.8168693009118541
".Jackson County, South Dakota",2805,2799,2864,2832,2776,-23,-0.8199643493761141
".Marion County, Ohio",65353,65388,65310,64609,64851,-537,-0.8216914296206754
".Foard County, Texas",1095,1088,1056,1063,1079,-9,-0.821917808219178
".Swift County, Minnesota",9830,9800,9782,9771,9719,-81,-0.8240081383519837
".Ogle County, Illinois",51780,51692,51464,51345,51265,-427,-0.8246427191966009
".Yell County, Arkansas",20256,20212,20135,20091,20044,-168,-0.8293838862559242
".Marion County, Indiana",977202,976659,971543,969223,968460,-8199,-0.8390281640848054
".Putnam County, West Virginia",57441,57444,57359,57063,56962,-482,-0.8391218815828416
".Morgan County, Ohio",13807,13762,13703,13669,13646,-116,-0.840153545303107
".Island County, Washington",86851,86998,87566,86682,86267,-731,-0.8416713682053172
".Redwood County, Minnesota",15427,15418,15388,15358,15288,-130,-0.8426784209502819
".Buena Vista city, Virginia",6641,6622,6622,6569,6566,-56,-0.8432464990212317
".Thomas County, Kansas",7930,7932,7948,7908,7865,-67,-0.8448928121059268
".Gallia County, Ohio",29216,29233,29224,29030,28986,-247,-0.8454271631982476
".Gogebic County, Michigan",14376,14346,14367,14377,14224,-122,-0.8486366165831942
".Winnebago County, Iowa",10683,10662,10661,10639,10571,-91,-0.8518206496302536
".Wabash County, Indiana",30981,30934,30893,30842,30670,-264,-0.8521351796262224
".Riley County, Kansas",71964,72016,71871,71563,71402,-614,-0.8532043799677617
".Logan County, North Dakota",1875,1885,1863,1838,1869,-16,-0.8533333333333334
".Turner County, Georgia",9003,8986,8919,8836,8909,-77,-0.855270465400422
".Franklin County, Alabama",32112,32078,31998,31910,31802,-276,-0.85949177877429
".Hampden County, Massachusetts",465839,464311,462862,460758,460291,-4020,-0.8629590910164242
".Dodge County, Georgia",20001,19949,19734,19873,19776,-173,-0.8649567521623918
".Russell County, Alabama",59182,59258,58681,58594,58744,-514,-0.8685073164137744
".Guernsey County, Ohio",38442,38423,38287,38060,38089,-334,-0.8688413714166796
".Noble County, Oklahoma",10929,10927,10941,10845,10832,-95,-0.8692469576356483
".Marion County, Kansas",11834,11793,11750,11783,11690,-103,-0.8703735000845023
".Lewis County, Kentucky",13083,13087,12991,12937,12973,-114,-0.871359779867003
".Sabine Parish, Louisiana",22149,22099,22096,21974,21906,-193,-0.8713711679985553
".Union County, Oregon",26200,26173,26288,26165,25944,-229,-0.8740458015267176
".Boone County, Nebraska",5375,5357,5382,5366,5310,-47,-0.8744186046511627
".Treutlen County, Georgia",6401,6397,6365,6359,6341,-56,-0.8748633026089674
".Crawford County, Wisconsin",16114,16085,16097,16015,15944,-141,-0.8750155144594762
".Murray County, Oklahoma",13903,13876,13716,13681,13754,-122,-0.8775084514133641
".Crowley County, Colorado",5919,5688,5735,5627,5636,-52,-0.8785267781719884
".Chouteau County, Montana",5898,5899,5921,5908,5847,-52,-0.8816547982366905
".Carroll County, Missouri",8495,8466,8398,8420,8391,-75,-0.8828722778104767
".Tipton County, Indiana",15357,15392,15394,15325,15256,-136,-0.8855896333919385
".Stoddard County, Missouri",28677,28651,28519,28390,28397,-254,-0.8857272378561216
".Haskell County, Texas",5413,5433,5375,5376,5385,-48,-0.886754110474783
".Harney County, Oregon",7504,7507,7602,7532,7440,-67,-0.8928571428571428
".Adams County, Nebraska",31199,31178,30967,30947,30899,-279,-0.8942594313920318
".Sherman County, Kansas",5926,5897,5932,5876,5844,-53,-0.8943638204522443
".McLean County, Kentucky",9153,9136,9122,9107,9054,-82,-0.8958811318693324
".Marshall County, Kansas",10034,10023,10021,9992,9933,-90,-0.8969503687462627
".Westmoreland County, Pennsylvania",354672,354346,353717,351998,351163,-3183,-0.8974489105426985
".Keokuk County, Iowa",10026,10004,9902,9883,9914,-90,-0.8976660682226212
".Shasta County, California",182158,182002,182135,180937,180366,-1636,-0.8981214110826865
".Baldwin County, Georgia",43789,43790,43695,43633,43396,-394,-0.8997693484665099
".Sheridan County, Kansas",2442,2445,2451,2439,2423,-22,-0.9009009009009009
".Hall County, Nebraska",62893,62764,62075,62096,62197,-567,-0.9015311719905236
".Cumberland County, New Jersey",154160,153719,152083,151347,152326,-1393,-0.9036066424494033
".Hood River County, Oregon",23980,23962,24086,24035,23745,-217,-0.9049207673060885
".Clinton County, Kentucky",9253,9232,9282,9139,9148,-84,-0.9078136820490652
".Auglaize County, Ohio",46427,46472,46255,45946,46050,-422,-0.908953841514636
".Ionia County, Michigan",66791,66870,66823,66836,66262,-608,-0.9103022862361695
".Montgomery County, Virginia",99719,99574,98788,98826,98666,-908,-0.910558669862313
".Tuscola County, Michigan",53322,53312,53034,52908,52826,-486,-0.9114436817823788
".Randolph County, Illinois",30164,30090,30204,30026,29815,-275,-0.9116828006895638
".Carter County, Kentucky",26626,26609,26430,26343,26366,-243,-0.9126417787125366
".Wheatland County, Montana",2070,2076,2042,2038,2057,-19,-0.9178743961352657
".Herkimer County, New York",60144,60037,60023,59584,59484,-553,-0.9194599627560522
".Darke County, Ohio",51873,51893,51642,51526,51415,-478,-0.9214813101227999
".Sevier County, Arkansas",15839,15778,15714,15738,15632,-146,-0.9217753646063513
".Powell County, Kentucky",13125,13093,13086,13041,12972,-121,-0.921904761904762
".Mercer County, Illinois",15698,15632,15580,15533,15487,-145,-0.9236845458020129
".Carroll County, Illinois",15707,15672,15702,15579,15526,-146,-0.9295218692302795
".Mitchell County, Kansas",5792,5773,5744,5730,5719,-54,-0.9323204419889504
".Mason County, Texas",3951,3968,3929,3978,3931,-37,-0.9364717792963807
".Clark County, Ohio",135971,135887,135608,134732,134610,-1277,-0.9391708526082768
".Ramsey County, North Dakota",11602,11572,11611,11516,11463,-109,-0.9394931908291673
".Pawnee County, Nebraska",2545,2536,2538,2531,2512,-24,-0.9430255402750491
".Contra Costa County, California",1165930,1166069,1163941,1157019,1155025,-11044,-0.9472266774163114
".Tom Green County, Texas",120007,120195,119231,118913,119057,-1138,-0.9482780171156682
".Curry County, Oregon",23450,23519,23719,23613,23296,-223,-0.9509594882729211
".Poweshiek County, Iowa",18659,18631,18624,18518,18453,-178,-0.9539632349000482
".Moultrie County, Illinois",14527,14481,14561,14375,14342,-139,-0.9568389894678875
".Seneca County, Ohio",55076,55054,54864,54534,54527,-527,-0.956859612172271
".McDonough County, Illinois",27232,27100,26880,26914,26839,-261,-0.9584312573443008
".Kit Carson County, Colorado",7081,7062,6927,6983,6994,-68,-0.9603163395000706
".Wayne County, Tennessee",16231,16222,16329,16266,16066,-156,-0.9611237754913438
".Alger County, Michigan",8836,8842,8774,8773,8757,-85,-0.961973743775464
".Deaf Smith County, Texas",18584,18526,18379,18399,18347,-179,-0.9631941455015067
".Allen County, Kansas",12522,12533,12498,12489,12412,-121,-0.9662993132087526
".Hopkins County, Kentucky",45421,45369,45189,44926,44929,-440,-0.9687149116047643
".Rensselaer County, New York",161124,160871,160622,159421,159305,-1566,-0.9719222462203023
".O'Brien County, Iowa",14181,14150,14044,14085,14012,-138,-0.9731330653691559
".Newton County, Texas",12217,12158,12212,12041,12039,-119,-0.9740525497257919
".Scotts Bluff County, Nebraska",36094,36051,35904,35769,35699,-352,-0.9752313403889844
".Las Animas County, Colorado",14559,14490,14334,14311,14348,-142,-0.975341713029741
".Oktibbeha County, Mississippi",51787,51709,51812,51384,51203,-506,-0.9770791897580474
".Rio Arriba County, New Mexico",40360,40271,40216,39991,39876,-395,-0.9786917740336968
".Carroll County, Iowa",20759,20726,20740,20541,20522,-204,-0.9827062960643576
".Lincoln County, Kansas",2940,2949,2910,2911,2920,-29,-0.9863945578231291
".Glacier County, Montana",13777,13745,13724,13650,13609,-136,-0.9871525005443856
".Traill County, North Dakota",7998,7987,7987,7955,7908,-79,-0.9877469367341836
".Platte County, Wyoming",8601,8631,8677,8652,8546,-85,-0.9882571793977444
".Zapata County, Texas",13887,13875,13875,13838,13736,-139,-1.0009361273133146
".Christian County, Kentucky",72813,72762,73180,72286,72032,-730,-1.0025682227074835
".LaSalle County, Illinois",109650,109410,109160,108181,108309,-1101,-1.0041039671682626
".Allegany County, Maryland",68108,67960,67687,67266,67273,-687,-1.0086920772890116
".Kenosha County, Wisconsin",169150,169195,168414,167637,167488,-1707,-1.0091634643807272
".Yates County, New York",24769,24722,24638,24502,24472,-250,-1.0093261738463402
".Cuming County, Nebraska",9010,9009,8990,8953,8918,-91,-1.0099889012208656
".Lee County, Kentucky",7391,7368,7462,7273,7293,-75,-1.014747666080368
".Baltimore County, Maryland",854554,853387,850691,845986,844703,-8684,-1.0162026039314076
".Knox County, Nebraska",8393,8384,8406,8307,8298,-86,-1.0246634099845109
".Juniata County, Pennsylvania",23508,23484,23355,23281,23243,-241,-1.0251829164539732
".Big Stone County, Minnesota",5168,5158,5167,5149,5105,-53,-1.0255417956656347
".Essex County, New Jersey",862768,859974,854233,849724,851117,-8857,-1.0265795671605809
".Lac qui Parle County, Minnesota",6719,6699,6700,6656,6630,-69,-1.0269385325197202
".St. Landry Parish, Louisiana",82557,82314,82191,81679,81464,-850,-1.0295916760541202
".Humboldt County, Iowa",9599,9599,9630,9521,9500,-99,-1.0313574330659443
".Aleutians West Census Area, Alaska",5225,5214,5147,5090,5160,-54,-1.0334928229665072
".Pulaski County, Indiana",12514,12515,12360,12449,12385,-130,-1.0388365031165094
".Gates County, North Carolina",10478,10452,10403,10370,10343,-109,-1.040274861614812
".Bristol County, Rhode Island",50789,50784,50774,50307,50255,-529,-1.041564118214574
".Cedar County, Iowa",18500,18495,18436,18353,18302,-193,-1.0432432432432432
".Miner County, South Dakota",2300,2304,2311,2285,2280,-24,-1.0434782608695654
".Jasper County, Illinois",9287,9241,9193,9172,9144,-97,-1.0444707655863035
".Broome County, New York",198683,198156,198562,197258,196077,-2079,-1.0463904813194889
".Genesee County, Michigan",406217,405777,404627,401923,401522,-4255,-1.0474697021542674
".Hand County, South Dakota",3141,3140,3079,3112,3107,-33,-1.0506208213944603
".Muhlenberg County, Kentucky",30933,30894,30323,30696,30568,-326,-1.05389066692529
".Mahoning County, Ohio",228612,228009,226529,225922,225596,-2413,-1.0555001487236015
".Westchester County, New York",1004469,1001453,999856,991736,990817,-10636,-1.0588679192687878
".Garfield County, Oklahoma",62839,62691,61964,61951,62023,-668,-1.0630341030251913
".Orange County, Indiana",19870,19850,19806,19601,19638,-212,-1.0669350780070457
".Effingham County, Illinois",34676,34703,34508,34300,34331,-372,-1.0727880955127465
".Grant Parish, Louisiana",22171,22149,22256,22040,21911,-238,-1.073474358396103
".Armstrong County, Texas",1849,1852,1840,1857,1832,-20,-1.0816657652785289
".Washington Parish, Louisiana",45463,45357,45198,44991,44865,-492,-1.0821987110397466
".Valley County, Montana",7576,7556,7560,7542,7474,-82,-1.082365364308342
".DuPage County, Illinois",932884,931317,926848,921664,921213,-10104,-1.083092860419945
".Russell County, Virginia",25784,25757,25572,25437,25477,-280,-1.085944771951598
".Cheyenne County, Colorado",1749,1746,1719,1731,1727,-19,-1.0863350485991996
".Madison County, Illinois",265868,265643,264867,263572,262752,-2891,-1.0873817082161072
".Putnam County, Missouri",4678,4689,4695,4662,4638,-51,-1.0902094912355709
".Cowley County, Kansas",34554,34534,34624,34423,34157,-377,-1.09104589917231
".Yuma County, Colorado",9981,9971,9925,9895,9862,-109,-1.092074942390542
".Jefferson County, New York",116711,116069,116902,115461,114787,-1282,-1.098439735757555
".Preble County, Ohio",40998,41007,40871,40574,40556,-451,-1.1000536611542027
".Hamilton County, Illinois",7996,7999,7913,7981,7911,-88,-1.1005502751375689
".Brown County, Minnesota",25920,25914,25899,25762,25628,-286,-1.103395061728395
".Saginaw County, Michigan",190129,189882,189516,188373,187782,-2100,-1.1045132515292249
".Carson City, Nevada",58646,58686,58764,58065,58036,-650,-1.1083449851652287
".Grant County, Wisconsin",51943,51985,51296,51315,51409,-576,-1.1089078412875653
".Valley County, Nebraska",4057,4057,4062,4058,4012,-45,-1.1091939857037219
".Erie County, Pennsylvania",270892,270578,269257,268840,267571,-3007,-1.1100364720995821
".San Augustine County, Texas",7919,7921,7905,7860,7833,-88,-1.1112514206339184
".Newton County, Mississippi",21294,21256,21120,21023,21019,-237,-1.112989574528036
".St. Martin Parish, Louisiana",51768,51634,51562,51249,51057,-577,-1.1145881625714726
".Hopewell city, Virginia",23031,23009,23073,22790,22752,-257,-1.1158872823585604
".Saline County, Nebraska",14767,14720,14525,14548,14555,-165,-1.1173562673528814
".Graham County, Kansas",2412,2403,2400,2397,2376,-27,-1.1194029850746268
".Tillman County, Oklahoma",6964,6947,7040,6971,6869,-78,-1.1200459506031017
".Butler County, Iowa",14335,14333,14348,14246,14172,-161,-1.1231252179979072
".San Juan County, Utah",14513,14521,14498,14406,14358,-163,-1.1231309860125405
".Phillips County, Colorado",4533,4527,4502,4448,4476,-51,-1.1250827266710788
".St. Helena Parish, Louisiana",10922,10898,10903,10789,10774,-124,-1.1353232008789598
".Wayne County, Missouri",10974,10936,10922,10817,10811,-125,-1.139055950428285
".Jackson County, Wisconsin",21142,21096,20915,20893,20855,-241,-1.1399110774761139
".McIntosh County, North Dakota",2535,2517,2517,2495,2488,-29,-1.143984220907298
".Winneshiek County, Iowa",20064,20045,19935,19902,19815,-230,-1.1463317384370015
".Buena Vista County, Iowa",20825,20806,20790,20644,20567,-239,-1.1476590636254502
".Fallon County, Montana",3049,3029,3011,3050,2994,-35,-1.1479173499508035
".Logan County, Illinois",27995,27912,27979,27666,27590,-322,-1.1502053938203252
".Sac County, Iowa",9822,9799,9768,9689,9686,-113,-1.1504785176135206
".Wasco County, Oregon",26670,26640,26739,26555,26333,-307,-1.1511061117360328
".Crawford County, Ohio",42016,42013,41782,41509,41529,-484,-1.151942117288652
".Barnes County, North Dakota",10851,10851,10815,10761,10726,-125,-1.1519675605934938
".Jefferson County, Colorado",582886,583081,580703,575811,576366,-6715,-1.1520262967372694
".Chautauqua County, Kansas",3384,3386,3389,3387,3347,-39,-1.152482269503546
".Page County, Iowa",15207,15190,15220,15176,15014,-176,-1.1573617413033472
".East Feliciana Parish, Louisiana",19541,19456,19373,19208,19229,-227,-1.1616600992784403
".Hayes County, Nebraska",859,856,850,864,846,-10,-1.1641443538998837
".Pike County, Indiana",12253,12249,12170,12143,12106,-143,-1.1670611278870482
".Mariposa County, California",17126,17119,17127,17053,16919,-200,-1.1678150181011326
".Hardin County, Ohio",30690,30727,30448,30391,30368,-359,-1.169762137504073
".Monroe County, Iowa",7570,7593,7581,7530,7504,-89,-1.1756935270805813
".Tazewell County, Illinois",131341,131086,130412,129610,129541,-1545,-1.1763272702354939
".Coos County, Oregon",64933,64979,65126,64923,64212,-767,-1.1812175627184944
".Cibola County, New Mexico",27175,27101,27185,26871,26780,-321,-1.1812327506899725
".Obion County, Tennessee",30793,30775,30459,30374,30411,-364,-1.1820868379177085
".Sheridan County, Montana",3546,3540,3576,3555,3498,-42,-1.1844331641285957
".Portsmouth city, Virginia",97912,97955,97652,96954,96793,-1162,-1.1867799656834708
".Howard County, Iowa",9465,9489,9496,9509,9376,-113,-1.1938721605916536
".Monroe County, New York",759430,757551,755813,750887,748482,-9069,-1.1941851125185996
".Lee County, Illinois",34151,34062,34195,33938,33654,-408,-1.1946941524406314
".Bay County, Michigan",103855,103742,103108,102638,102500,-1242,-1.195898127196572
".Upshur County, West Virginia",23815,23814,23803,23705,23529,-285,-1.1967247533067393
".Marion County, Georgia",7505,7530,7434,7436,7440,-90,-1.1992005329780147
".Tehama County, California",65832,65687,65446,65299,64896,-791,-1.201543322396403
".Carbon County, Wyoming",14535,14509,14714,14538,14334,-175,-1.2039903680770554
".Harrisonburg city, Virginia",51810,51706,51497,51150,51082,-624,-1.2044006948465547
".Fayette County, Iowa",19510,19445,19295,19266,19210,-235,-1.204510507432086
".Webster County, Nebraska",3398,3392,3402,3339,3351,-41,-1.2065921130076516
".Pocahontas County, West Virginia",7869,7860,7882,7797,7765,-95,-1.2072690303723472
".Perry County, Mississippi",11508,11454,11500,11398,11315,-139,-1.207855404935697
".Saline County, Missouri",23327,23331,23253,23003,23049,-282,-1.2088995584515796
".Kiowa County, Oklahoma",8510,8501,8404,8480,8398,-103,-1.2103407755581668
".Elliott County, Kentucky",7352,7334,7361,7292,7245,-89,-1.2105549510337323
".Huntingdon County, Pennsylvania",44087,44049,43958,43297,43514,-535,-1.2135096513711525
".Refugio County, Texas",6744,6748,6704,6638,6666,-82,-1.2158956109134045
".Wilkinson County, Georgia",8875,8833,8786,8677,8725,-108,-1.2169014084507042
".Ottawa County, Ohio",40362,40296,40166,39968,39803,-493,-1.2214459144740102
".Putnam County, Illinois",5636,5630,5588,5553,5561,-69,-1.2242725337118523
".Steuben County, New York",93571,93309,93087,92505,92162,-1147,-1.2258071411014098
".Lycoming County, Pennsylvania",114189,114125,113561,113034,112724,-1401,-1.2269132753592729
".Mono County, California",13201,13228,13271,13002,13066,-162,-1.2271797591091584
".Bland County, Virginia",6273,6256,6177,6138,6179,-77,-1.2274828630639247
".Morrill County, Nebraska",4562,4560,4569,4522,4504,-56,-1.2275317843051292
".Liberty County, Florida",7978,7804,7290,7613,7706,-98,-1.2283780396089246
".Kankakee County, Illinois",107510,107264,106605,105998,105940,-1324,-1.2315133475955724
".Freeborn County, Minnesota",30893,30896,30803,30683,30515,-381,-1.2332890946169035
".Mercer County, New Jersey",387328,386466,382172,380779,381671,-4795,-1.2379688532716457
".Boulder County, Colorado",330759,330938,327084,327339,326831,-4107,-1.2416895685378175
".Sumter County, South Carolina",105548,105476,104854,103936,104165,-1311,-1.2420889074165309
".Mercer County, Missouri",3537,3513,3481,3466,3469,-44,-1.2439920836867402
".Lucas County, Ohio",431281,430859,429482,426719,425484,-5375,-1.2462872234111866
".Wheeler County, Oregon",1443,1454,1447,1435,1436,-18,-1.2474012474012475
".Henderson County, Kentucky",44798,44678,44418,44032,44119,-559,-1.2478235635519443
".Pope County, Illinois",3764,3754,3758,3746,3707,-47,-1.248671625929862
".Box Butte County, Nebraska",10842,10828,10663,10683,10692,-136,-1.2543811104962184
".Berrien County, Michigan",154318,154197,153352,152835,152261,-1936,-1.2545522881322984
".Niagara County, New York",212666,212126,211719,210467,209457,-2669,-1.255019608211938
".Dodge County, Wisconsin",89394,89353,88689,88374,88231,-1122,-1.255117793140479
".Emmet County, Iowa",9393,9347,9334,9214,9229,-118,-1.256254657723837
".Pocahontas County, Iowa",7075,7065,7039,7073,6976,-89,-1.2579505300353355
".Allen County, Ohio",102211,102125,101784,101097,100838,-1287,-1.2591599729970355
".Daniels County, Montana",1657,1654,1671,1645,1633,-21,-1.2673506336753169
".Franklin County, Iowa",10019,10002,9952,9946,9875,-127,-1.2675915760055894
".Coffey County, Kansas",8359,8357,8337,8252,8251,-106,-1.2680942696494797
".Ketchikan Gateway Borough, Alaska",13953,13915,13866,13772,13738,-177,-1.2685443990539669
".Rowan County, Kentucky",24656,24722,24569,24372,24409,-313,-1.2694678780012978
".Dawson County, Montana",8944,8924,8858,8807,8810,-114,-1.2745974955277282
".Jackson County, Oregon",223255,223620,224353,221669,220768,-2852,-1.277462990750487
".St. Lawrence County, New York",108501,108329,107823,107089,106940,-1389,-1.2801725329720464
".Brown County, South Dakota",38304,38225,38117,37901,37733,-492,-1.2844611528822054
".Chickasaw County, Mississippi",17110,17086,17007,16863,16866,-220,-1.2857977790765636
".Bradford County, Florida",28302,28222,28050,27296,27858,-364,-1.286128188820578
".Covington County, Mississippi",18335,18295,18273,18142,18059,-236,-1.2871557131169893
".Hancock County, Iowa",10789,10754,10680,10651,10615,-139,-1.2883492446009825
".Mahaska County, Iowa",22190,22160,21974,21971,21874,-286,-1.2888688598467777
".Rockbridge County, Virginia",22652,22650,22638,22568,22358,-292,-1.2890693978456649
".Rock County, Minnesota",9693,9676,9685,9554,9551,-125,-1.2895904260806768
".Wood County, West Virginia",84292,84142,83804,83388,83052,-1090,-1.2931239026242112
".Knox County, Kentucky",30197,30185,30025,29773,29794,-391,-1.2948306123124813
".Garrett County, Maryland",28807,28798,28758,28588,28423,-375,-1.3017669316485576
".Beckham County, Oklahoma",22408,22334,22032,21976,22042,-292,-1.303106033559443
".Tioga County, New York",48452,48348,48080,47766,47715,-633,-1.3064476182613722
".Williams County, Ohio",37104,37078,36763,36648,36591,-487,-1.3125269512721
".Virginia Beach city, Virginia",459476,459684,458569,455069,453649,-6035,-1.3134527157022347
".Pittsylvania County, Virginia",60498,60367,60038,59824,59571,-796,-1.3157459750735563
".Cherokee County, Kansas",19367,19309,19186,19025,19054,-255,-1.316672690659369
".Livingston County, Illinois",35827,35792,35769,35517,35320,-472,-1.3174421525665
".Sonoma County, California",488850,488282,484519,482669,481812,-6470,-1.3235143704612868
".Genesee County, New York",58383,58302,57889,57398,57529,-773,-1.3240155524724664
".Swain County, North Carolina",14117,14103,14128,13936,13916,-187,-1.3246440461854503
".Dakota County, Nebraska",21587,21554,21282,21116,21268,-286,-1.324871450409969
".Onondaga County, New York",476523,474192,471887,469728,467873,-6319,-1.3260640095021645
".Apache County, Arizona",66026,65913,65389,65533,65036,-877,-1.3282646230272923
".Todd County, South Dakota",9324,9323,9301,9233,9199,-124,-1.3299013299013298
".Bowie County, Texas",92899,92923,92282,91712,91687,-1236,-1.3304771848997299
".Beaver County, Pennsylvania",168229,167873,166967,165737,165631,-2242,-1.3327072026820586
".Gray County, Texas",21229,21199,21128,20980,20916,-283,-1.3330821046681425
".Essex County, New York",37374,37275,37233,36763,36775,-500,-1.3378284368812543
".Knox County, Texas",3354,3347,3318,3284,3302,-45,-1.3416815742397137
".Monroe County, Pennsylvania",168309,168314,168676,167451,166053,-2261,-1.3433625058671848
".Orangeburg County, South Carolina",84221,83954,82815,83101,82820,-1134,-1.346457534344166
".Cedar County, Nebraska",8380,8375,8332,8366,8262,-113,-1.3484486873508352
".Clinton County, Indiana",33189,33178,32983,32769,32730,-448,-1.3498448281056976
".Sargent County, North Dakota",3851,3828,3829,3804,3776,-52,-1.350298623734095
".Sangamon County, Illinois",196341,196144,195371,194151,193491,-2653,-1.3512205805206248
".Jones County, Mississippi",67244,67163,66813,66440,66250,-913,-1.3577419546725358
".Doddridge County, West Virginia",7807,7786,7738,7712,7680,-106,-1.3577558601255284
".Washington County, Illinois",13758,13723,13640,13623,13536,-187,-1.3592091873818868
".Appanoose County, Iowa",12316,12287,12269,12141,12119,-168,-1.3640792465086067
".Charles Mix County, South Dakota",9382,9368,9184,9232,9240,-128,-1.364314645065018
".Comanche County, Kansas",1685,1678,1663,1690,1655,-23,-1.3649851632047478
".Jo Daviess County, Illinois",22043,22057,21972,21845,21756,-301,-1.365512861225786
".Jefferson County, Kentucky",782964,782845,777251,773095,772144,-10701,-1.3667295048048187
".Rice County, Kansas",9426,9389,9389,9370,9260,-129,-1.3685550604710375
".Crawford County, Missouri",23054,23035,22820,22659,22719,-316,-1.370694890257656
".Lincoln County, New Mexico",20266,20307,20400,20343,20029,-278,-1.3717556498569032
".Randolph County, Missouri",24707,24448,24563,24626,24109,-339,-1.3720807868215485
".Richmond County, North Carolina",42948,42914,42805,42573,42324,-590,-1.3737543075346932
".Calhoun County, Iowa",9931,9900,9895,9725,9763,-137,-1.3795186788843017
".Dickey County, North Dakota",4997,4969,4901,4928,4900,-69,-1.380828497098259
".Webster County, Iowa",37002,36996,37170,36652,36485,-511,-1.3810064320847522
".Adair County, Iowa",7497,7493,7524,7457,7389,-104,-1.3872215552887823
".Bureau County, Illinois",33243,33191,32959,32827,32729,-462,-1.3897662665824384
".Huron County, Michigan",31398,31364,31307,31145,30927,-437,-1.3918083954392
".Berkshire County, Massachusetts",129039,128619,128376,127547,126818,-1801,-1.3957020745666038
".Bond County, Illinois",16725,16684,16623,16536,16450,-234,-1.399103139013453
".Winnebago County, Illinois",285337,284916,283333,281542,280922,-3994,-1.3997483677195737
".Miami County, Indiana",35963,35906,35999,35546,35402,-504,-1.4014403692684148
".Little River County, Arkansas",12026,11974,11973,11865,11805,-169,-1.4052885414934309
".Clay County, Kansas",8110,8121,8090,8041,8007,-114,-1.4056720098643651
".Butte County, California",211630,210151,206336,207369,207172,-2979,-1.4076454188914616
".Winchester city, Virginia",28124,28013,28092,27861,27617,-396,-1.4080500640022757
".Tuscarawas County, Ohio",93265,93193,92618,91971,91874,-1319,-1.414249718543934
".Union County, Pennsylvania",42681,42646,42469,42690,42042,-604,-1.4151495981818607
".De Baca County, New Mexico",1695,1681,1679,1692,1657,-24,-1.415929203539823
".Jackson County, Illinois",52966,52891,52604,52477,52141,-750,-1.41600271872522
".Houston County, Minnesota",18846,18849,18819,18727,18582,-267,-1.416746259153136
".Harvey County, Kansas",34019,33986,33788,33671,33504,-482,-1.4168552867515212
".Chippewa County, Michigan",36783,36787,35849,36207,36264,-523,-1.4218524862028654
".Nodaway County, Missouri",21235,20997,20983,20715,20695,-302,-1.4221803626089002
".Cerro Gordo County, Iowa",43129,43022,42761,42426,42406,-616,-1.4282733195761554
".Murray County, Minnesota",8168,8166,8133,8040,8049,-117,-1.4324191968658178
".Kenedy County, Texas",349,348,339,354,343,-5,-1.4326647564469914
".Columbiana County, Ohio",101879,101642,101352,100569,100182,-1460,-1.4330725664759176
".Bibb County, Alabama",22301,22188,22359,21986,21868,-320,-1.4349132325904668
".Greene County, New York",47932,47752,47884,47345,47062,-690,-1.4395393474088292
".Nemaha County, Kansas",10274,10262,10226,10164,10114,-148,-1.4405294919213547
".Tama County, Iowa",17133,17081,16898,16943,16833,-248,-1.44749897857935
".Adams County, North Dakota",2208,2195,2169,2133,2163,-32,-1.4492753623188406
".Castro County, Texas",7373,7334,7366,7287,7227,-107,-1.4512410145124102
".Halifax County, Virginia",34024,33926,33777,33620,33432,-494,-1.4519162943804373
".Allegany County, New York",46450,47328,46938,46726,46651,-677,-1.4574811625403659
".Henry County, Illinois",49282,49167,48911,48596,48448,-719,-1.4589505296051297
".Des Moines County, Iowa",38910,38823,38506,38242,38253,-570,-1.4649190439475714
".Montgomery County, Alabama",228952,228342,226935,226301,224980,-3362,-1.4684300639435341
".Pickens County, Alabama",19130,18969,18618,18749,18688,-281,-1.468897020386827
".Tallapoosa County, Alabama",41309,41284,41099,40913,40677,-607,-1.4694134450119827
".Monroe County, Ohio",13383,13350,13331,13215,13153,-197,-1.4720167376522453
".Iberville Parish, Louisiana",30242,30064,29747,29613,29617,-447,-1.4780768467693934
".Franklin County, Illinois",37803,37697,37459,37215,37138,-559,-1.4787186202153269
".Brown County, Nebraska",2895,2896,2913,2883,2853,-43,-1.4853195164075994
".Madison County, New York",68017,67935,67382,67054,66921,-1014,-1.4908037696458238
".Choctaw County, Mississippi",8249,8211,8137,8095,8088,-123,-1.4910898290701904
".Watonwan County, Minnesota",11262,11245,11164,11106,11077,-168,-1.4917421417155035
".Montour County, Pennsylvania",18145,18131,18089,18054,17860,-271,-1.493524386883439
".Coles County, Illinois",46864,46760,46802,46346,46060,-700,-1.493683851143735
".Fulton County, Ohio",42713,42646,42499,42158,42007,-639,-1.4960316531266826
".Panola County, Mississippi",33203,33169,32908,32592,32669,-500,-1.5058880221666717
".Furnas County, Nebraska",4632,4626,4607,4570,4556,-70,-1.5112262521588946
".Fayette County, Illinois",21498,21490,21438,21270,21164,-326,-1.5164201321053121
".Oneida County, New York",232113,231082,229620,228358,227555,-3527,-1.5195185103807196
".Barbour County, Alabama",25229,24969,24533,24700,24585,-384,-1.5220579491854613
".Clarke County, Iowa",9754,9737,9756,9643,9588,-149,-1.527578429362313
".Washita County, Oklahoma",10921,10903,10899,10736,10736,-167,-1.5291639959710648
".Blaine County, Montana",7044,7007,7003,6972,6899,-108,-1.5332197614991483
".Columbia County, New York",61560,61414,61961,61108,60470,-944,-1.5334632878492527
".Sutter County, California",99636,99479,99152,98569,97948,-1531,-1.5365931992452528
".Union County, Indiana",7088,7082,7018,6967,6973,-109,-1.5378103837471784
".Winston County, Mississippi",17715,17690,17580,17504,17416,-274,-1.5467118261360429
".Monroe County, Mississippi",34177,34139,33922,33568,33609,-530,-1.5507505047254
".Northumberland County, Pennsylvania",91641,91545,90989,90123,90120,-1425,-1.554980849183226
".Dooly County, Georgia",11209,11156,10869,10585,10981,-175,-1.5612454277812473
".Ransom County, North Dakota",5700,5692,5682,5647,5603,-89,-1.5614035087719298
".Northampton County, Virginia",12281,12213,12068,11978,12021,-192,-1.563390603371061
".Oglala Lakota County, South Dakota",13671,13648,13559,13508,13434,-214,-1.5653573257259894
".Richland Parish, Louisiana",20041,20026,19856,19784,19712,-314,-1.5667880844269246
".Orange County, California",3186997,3185734,3160611,3150372,3135755,-49979,-1.568216098101128
".Audrain County, Missouri",24959,24786,24861,24482,24394,-392,-1.5705757442205217
".Newport News city, Virginia",186245,186047,184691,183980,183118,-2929,-1.5726596687159387
".Nicholas County, West Virginia",24603,24558,24429,24309,24169,-389,-1.581107994959964
".Ouachita Parish, Louisiana",160370,160111,158866,157704,157568,-2543,-1.5857080501340648
".Estill County, Kentucky",14164,14161,14086,14024,13936,-225,-1.5885343123411464
".Santa Barbara County, California",448220,448424,437521,443915,441257,-7167,-1.5989915666413814
".St. Louis County, Missouri",1004305,1003130,998439,990791,987059,-16071,-1.6002110912521592
".Avery County, North Carolina",17810,17847,17522,17541,17561,-286,-1.6058394160583942
".Jefferson County, Iowa",15665,15694,15781,15668,15440,-254,-1.6214490903287586
".Fulton County, New York",53333,53100,52747,52256,52234,-866,-1.623760148500928
".Mora County, New Mexico",4184,4191,4189,4147,4123,-68,-1.6252390057361379
".East Baton Rouge Parish, Louisiana",456783,455899,453596,450091,448467,-7432,-1.6270307782907858
".Ventura County, California",843840,843371,839471,832871,829590,-13781,-1.6331295032233601
".Fremont County, Iowa",6600,6566,6583,6475,6458,-108,-1.6363636363636365
".Pennington County, Minnesota",13988,13943,13781,13816,13714,-229,-1.637117529310838
".Lee County, Virginia",22172,22108,22005,21847,21745,-363,-1.6372000721630884
".Chambers County, Alabama",34772,34651,34488,34164,34079,-572,-1.6450017255262857
".Cumberland County, Illinois",10453,10433,10352,10308,10261,-172,-1.6454606333110113
".Martin County, Minnesota",20027,19987,19923,19656,19657,-330,-1.6477755030708543
".Anchorage Municipality, Alaska",291244,290893,289169,286983,286075,-4818,-1.6542830066885499
".Norman County, Minnesota",6443,6436,6441,6371,6329,-107,-1.6607170572714574
".Iowa County, Iowa",16665,16658,16586,16497,16381,-277,-1.6621662166216622
".Greenlee County, Arizona",9562,9528,9400,9327,9369,-159,-1.6628320435055428
".Scott County, Mississippi",27991,27974,27603,27560,27507,-467,-1.6683934121681967
".Humboldt County, California",136462,136262,134897,134944,133985,-2277,-1.668596385807038
".Shelby County, Illinois",20990,20919,20862,20710,20568,-351,-1.6722248689852308
".Kidder County, North Dakota",2389,2382,2354,2381,2342,-40,-1.6743407283382168
".Jackson Parish, Louisiana",15036,14998,14900,14816,14746,-252,-1.675977653631285
".Pendleton County, West Virginia",6144,6132,6093,6067,6029,-103,-1.6764322916666667
".Evangeline Parish, Louisiana",32342,32297,32213,32033,31754,-543,-1.678931420444005
".Walla Walla County, Washington",62585,62623,62211,61853,61568,-1055,-1.6857074378844772
".Macon County, Georgia",12080,12021,11852,11777,11817,-204,-1.6887417218543046
".Washtenaw County, Michigan",372258,371834,365013,366504,365536,-6298,-1.6918373816009327
".Ballard County, Kentucky",7730,7713,7687,7642,7582,-131,-1.6946959896507117
".Decatur County, Kansas",2764,2759,2766,2689,2712,-47,-1.7004341534008685
".San Miguel County, New Mexico",27202,27131,27155,26902,26668,-463,-1.7020807293581353
".Lafayette County, Florida",8225,8218,7952,7777,8078,-140,-1.702127659574468
".Washington County, New York",61297,61091,60858,60810,60047,-1044,-1.703182863761685
".Sitka City and Borough, Alaska",8449,8426,8383,8353,8282,-144,-1.7043437093147116
".Mason County, Kentucky",17122,17133,16960,16903,16841,-292,-1.705408246700152
".Cottonwood County, Minnesota",11513,11516,11594,11382,11319,-197,-1.7111091809259098
".Cloud County, Kansas",9035,9009,8954,8934,8854,-155,-1.715550636413946
".Acadia Parish, Louisiana",57571,57478,57217,56725,56489,-989,-1.7178787931423807
".Alcorn County, Mississippi",34746,34733,34398,34147,34135,-598,-1.7210614171415415
".Summit County, Colorado",31055,31001,30998,30636,30465,-536,-1.7259700531315407
".Newton County, Arkansas",7228,7196,7167,7101,7071,-125,-1.7293857221914777
".Monterey County, California",439035,438322,437158,432884,430723,-7599,-1.7308415046636372
".Calhoun County, Florida",13644,13707,13518,13465,13470,-237,-1.7370272647317502
".Roane County, West Virginia",14028,13987,13932,13833,13743,-244,-1.7393783860849727
".Lawrence County, Pennsylvania",86071,85970,85554,84812,84472,-1498,-1.7404236037689813
".Danville city, Virginia",42590,42579,42285,42017,41837,-742,-1.7421930030523596
".Blackford County, Indiana",12109,12105,12041,11919,11893,-212,-1.7507638946238337
".Howard County, Arkansas",12786,12757,12695,12622,12533,-224,-1.7519161582981386
".Jefferson County, Alabama",674340,674717,669990,665084,662895,-11822,-1.7531215707210013
".Meigs County, Ohio",22206,22159,22078,21961,21767,-392,-1.7652886607223275
".Jefferson County, Ohio",65248,65178,65085,64273,64026,-1152,-1.7655713585090729
".Floyd County, Iowa",15638,15604,15465,15348,15326,-278,-1.7777209361810973
".Greenwood County, Kansas",6018,5977,5921,5908,5870,-107,-1.777999335327351
".Buchanan County, Missouri",84796,84467,83623,82891,82956,-1511,-1.7819236756450776
".McCulloch County, Texas",7631,7588,7522,7468,7452,-136,-1.7822041672126852
".Hocking County, Ohio",28053,28040,28101,27818,27540,-500,-1.782340569636046
".Cattaraugus County, New York",77034,76974,76539,76050,75600,-1374,-1.78362800841187
".Adams County, Illinois",65729,65614,65064,64556,64441,-1173,-1.7846004046919928
".Charlotte County, Virginia",11533,11542,11499,11400,11336,-206,-1.786178791294546
".Rosebud County, Montana",8335,8309,8086,8152,8160,-149,-1.7876424715056989
".Hennepin County, Minnesota",1281571,1281649,1270055,1257066,1258713,-22936,-1.7896784493406919
".Washington County, Ohio",59767,59647,59486,58868,58577,-1070,-1.7902856091153982
".Wyoming County, New York",40544,40259,39927,39601,39532,-727,-1.7931136543014994
".Fisher County, Texas",3673,3678,3675,3626,3612,-66,-1.7968962700789546
".Tishomingo County, Mississippi",18854,18846,18734,18621,18507,-339,-1.798026943884587
".Osborne County, Kansas",3494,3490,3485,3481,3427,-63,-1.8030910131654265
".Jefferson County, Texas",256521,256133,253727,251601,251496,-4637,-1.807649276277576
".Hickman County, Kentucky",4521,4529,4426,4434,4447,-82,-1.81375801813758
".Taylor County, West Virginia",16704,16691,16528,16410,16388,-303,-1.8139367816091954
".Lenawee County, Michigan",99422,99325,99100,98280,97520,-1805,-1.8154935527348073
".Johnson County, Nebraska",5287,5294,5314,5245,5198,-96,-1.8157745413277853
".Jefferson County, Illinois",37110,36995,36889,36419,36320,-675,-1.818916734033953
".Harrison County, West Virginia",65914,65838,65402,64752,64639,-1199,-1.8190369269047546
".Greenup County, Kentucky",35958,35877,35643,35375,35221,-656,-1.824350631292063
".Pipestone County, Minnesota",9420,9417,9354,9327,9245,-172,-1.8259023354564756
".Perry County, Illinois",20941,20886,21014,20512,20503,-383,-1.8289479967527815
".Calhoun County, Texas",20105,20064,19782,19682,19696,-368,-1.8303904501367818
".Hamilton County, Florida",14003,13729,13072,13194,13471,-258,-1.8424623295008213
".Lincoln County, Minnesota",5641,5625,5576,5576,5521,-104,-1.8436447438397447
".Denali Borough, Alaska",1624,1614,1595,1575,1584,-30,-1.8472906403940887
".Mahnomen County, Minnesota",5408,5380,5403,5339,5280,-100,-1.849112426035503
".Mercer County, Pennsylvania",110658,110550,109958,109137,108503,-2047,-1.8498436624554935
".Venango County, Pennsylvania",50462,50365,50040,49734,49431,-934,-1.8508977052039157
".Dixon County, Nebraska",5611,5595,5570,5516,5491,-104,-1.8535020495455357
".Prince George's County, Maryland",967215,965365,956451,946980,947430,-17935,-1.8542929958695844
".Hamilton County, Iowa",15037,15008,14863,14803,14729,-279,-1.8554232892199243
".Blaine County, Oklahoma",8728,8701,8547,8445,8539,-162,-1.8560953253895511
".Wyandot County, Ohio",21896,21864,21689,21552,21457,-407,-1.858786993058093
".Lawrence County, Kentucky",16291,16303,16284,16097,16000,-303,-1.8599226566816034
".Marion County, Texas",9727,9752,9620,9550,9571,-181,-1.8607998355094069
".Union County, Iowa",12142,12132,12049,11903,11906,-226,-1.8613078570252017
".Macoupin County, Illinois",44973,44856,44492,44123,44018,-838,-1.863340226358037
".Worth County, Iowa",7445,7436,7377,7311,7297,-139,-1.8670248488918735
".Griggs County, North Dakota",2300,2291,2281,2249,2248,-43,-1.8695652173913044
".Jersey County, Illinois",21518,21494,21349,21191,21091,-403,-1.872850636676271
".Montgomery County, Iowa",10329,10333,10316,10210,10139,-194,-1.8782069900280762
".Crawford County, Illinois",18674,18651,18684,18495,18300,-351,-1.8796187212166648
".Emmons County, North Dakota",3298,3286,3257,3254,3224,-62,-1.879927228623408
".Roosevelt County, New Mexico",19188,19148,18992,18858,18787,-361,-1.8813841984573692
".La Salle County, Texas",6666,6663,6708,6556,6537,-126,-1.8901890189018902
".Braxton County, West Virginia",12449,12398,12296,12170,12162,-236,-1.8957345971563981
".Harper County, Oklahoma",3270,3252,3177,3165,3190,-62,-1.8960244648318043
".Edwards County, Texas",1423,1420,1429,1428,1393,-27,-1.8973998594518624
".Cambria County, Pennsylvania",133478,133211,132237,131429,130668,-2543,-1.905182876578912
".Montgomery County, Illinois",28283,28202,28082,27901,27663,-539,-1.9057384294452497
".Atchison County, Kansas",16347,16328,16236,16053,16016,-312,-1.9086070838685996
".Richland County, Illinois",15811,15790,15767,15555,15488,-302,-1.9100626146353803
".Erie County, Ohio",75619,75481,74886,74514,74035,-1446,-1.912217828852537
".Passaic County, New Jersey",525054,523439,518376,513634,513395,-10044,-1.9129460969728829
".Gilmer County, West Virginia",7415,7396,7392,7330,7254,-142,-1.9150370869858393
".Whiteside County, Illinois",55694,55565,55302,54555,54498,-1067,-1.9158257622005963
".Smyth County, Virginia",29801,29787,29608,29408,29216,-571,-1.9160430858024897
".Hardeman County, Texas",3548,3558,3546,3525,3490,-68,-1.9165727170236753
".Greene County, Iowa",8764,8752,8724,8710,8584,-168,-1.9169329073482428
".Dunn County, North Dakota",4094,4098,4018,3994,4019,-79,-1.9296531509526136
".Warren County, Georgia",5210,5207,5208,5157,5106,-101,-1.9385796545105565
".Randolph County, West Virginia",27933,27892,27898,27552,27350,-542,-1.940357283499803
".Ford County, Illinois",13526,13513,13479,13256,13250,-263,-1.9444033712849327
".Crittenden County, Arkansas",48156,48076,47438,47051,47139,-937,-1.945759614585929
".Chautauqua County, New York",127657,127376,126183,125344,124891,-2485,-1.9466225902222363
".Blair County, Pennsylvania",122827,122666,122150,120734,120273,-2393,-1.948268703135304
".Arlington County, Virginia",238642,238814,233436,233678,234162,-4652,-1.9493634817006227
".Cotton County, Oklahoma",5523,5535,5442,5449,5427,-108,-1.9554589896795218
".Schuyler County, Illinois",6899,6868,6831,6753,6733,-135,-1.9568053341063922
".Palo Alto County, Iowa",8994,8986,8923,8790,8810,-176,-1.9568601289748724
".Giles County, Virginia",16792,16786,16572,16432,16457,-329,-1.9592663172939495
".Schleicher County, Texas",2448,2439,2438,2359,2391,-48,-1.9607843137254901
".Newport County, Rhode Island",85649,85515,85608,84721,83832,-1683,-1.964996672465528
".Jefferson County, Pennsylvania",44501,44487,44120,43731,43612,-875,-1.9662479494842813
".Nevada County, Arkansas",8312,8284,8184,8179,8120,-164,-1.973051010587103
".Montgomery County, Mississippi",9819,9794,9699,9563,9600,-194,-1.9757612791526633
".Allegheny County, Pennsylvania",1250536,1249565,1245220,1232605,1224825,-24740,-1.9783516827984162
".Pike County, Mississippi",40326,40192,40010,39687,39394,-798,-1.978872191638149
".Marion County, South Carolina",29185,29086,28852,28471,28508,-578,-1.9804694192222032
".Lawrence County, Mississippi",12011,11979,11781,11761,11741,-238,-1.981516942802431
".Clinton County, New York",79838,79699,78993,78037,78115,-1584,-1.9840176357123176
".Hamilton County, Kansas",2517,2487,2478,2452,2437,-50,-1.9864918553833928
".Hancock County, Kentucky",9093,9101,9073,9027,8920,-181,-1.990542175299681
".Donley County, Texas",3261,3279,3361,3289,3214,-65,-1.9932536031892059
".Washington County, Alabama",15389,15329,15223,15094,15022,-307,-1.9949314445383066
".Schuyler County, New York",17894,17864,17789,17609,17507,-357,-1.9950821504414888
".Pierce County, North Dakota",3997,3982,3944,3931,3902,-80,-2.001501125844383
".Hardin County, Illinois",3647,3642,3635,3572,3569,-73,-2.00164518782561
".Calhoun County, Arkansas",4740,4736,4728,4687,4641,-95,-2.0042194092827006
".Charles City County, Virginia",6771,6746,6608,6568,6610,-136,-2.0085659429921727
".Wright County, Iowa",12942,12916,12813,12695,12656,-260,-2.00896306598671
".Stonewall County, Texas",1244,1243,1211,1218,1218,-25,-2.009646302250804
".Pike County, Illinois",14734,14640,14621,14499,14342,-298,-2.0225329170625765
".Union County, South Carolina",27240,27181,27010,26739,26629,-552,-2.026431718061674
".Hancock County, Illinois",17613,17543,17376,17254,17186,-357,-2.0269119400442857
".Juneau City and Borough, Alaska",32256,32209,31979,31740,31555,-654,-2.027529761904762
".Calhoun County, Illinois",4438,4407,4395,4353,4317,-90,-2.0279405137449302
".Amite County, Mississippi",12721,12700,12622,12559,12442,-258,-2.028142441631947
".Clarke County, Mississippi",15610,15545,15415,15203,15228,-317,-2.030749519538757
".Jefferson Davis Parish, Louisiana",32249,32210,32373,31929,31553,-657,-2.037272473565072
".Lauderdale County, Tennessee",25139,25123,24878,24741,24610,-513,-2.0406539639603802
".Cochran County, Texas",2547,2561,2480,2522,2509,-52,-2.0416175893207695
".Dillon County, South Carolina",28296,28277,27970,27747,27698,-579,-2.046225614927905
".Franklin County, New York",47573,47477,47106,46393,46502,-975,-2.0494818489479325
".Ness County, Kansas",2682,2673,2651,2657,2618,-55,-2.0507084265473527
".Jasper County, Mississippi",16367,16350,16232,16077,16013,-337,-2.0590212011975315
".Clay County, Illinois",13289,13273,13163,13077,12999,-274,-2.0618556701030926
".Belmont County, Ohio",66497,66292,65899,65495,64918,-1374,-2.066258628208791
".Barton County, Kansas",25501,25427,25263,25058,24899,-528,-2.0705070389396494
".Pawnee County, Kansas",6254,6256,6247,6188,6126,-130,-2.078669651423089
".Terry County, Texas",11831,11793,11714,11444,11547,-246,-2.079283238948525
".Modoc County, California",8703,8681,8641,8619,8500,-181,-2.0797426174882223
".Tippah County, Mississippi",21819,21742,21625,21438,21287,-455,-2.085338466474174
".Lamar County, Alabama",13972,13953,13736,13706,13661,-292,-2.0898940738620095
".Peoria County, Illinois",181836,181319,179638,178000,177513,-3806,-2.093094876702083
".Hettinger County, North Dakota",2483,2467,2425,2411,2415,-52,-2.094240837696335
".Union Parish, Louisiana",21105,21092,21001,20729,20650,-442,-2.0942904524994077
".Duval County, Texas",9829,9810,9998,9706,9604,-206,-2.095838844236443
".Crisp County, Georgia",20128,20053,20000,19729,19631,-422,-2.0965818759936408
".Calhoun County, Georgia",5575,5574,5541,5474,5457,-117,-2.0986547085201797
".Red Willow County, Nebraska",10701,10682,10620,10528,10457,-225,-2.1026072329688814
".Tuolumne County, California",55624,55379,55131,54587,54204,-1175,-2.112397526247663
".Cortland County, New York",46800,46741,46413,46081,45752,-989,-2.1132478632478633
".Tucker County, West Virginia",6759,6747,6693,6620,6604,-143,-2.115697588400651
".Hampton County, South Carolina",18555,18515,18244,18136,18122,-393,-2.11802748585287
".Shelby County, Tennessee",930020,929763,923382,916357,910042,-19721,-2.12049203242941
".Major County, Oklahoma",7781,7746,7636,7536,7581,-165,-2.1205500578331833
".Walsh County, North Dakota",10562,10529,10490,10460,10305,-224,-2.120810452565802
".Drew County, Arkansas",17345,17313,17057,16912,16945,-368,-2.121648890170078
".Sumter County, Georgia",29615,29520,28981,28864,28890,-630,-2.127300354550059
".Saline County, Kansas",54297,54254,53827,53389,53098,-1156,-2.12903106985653
".Early County, Georgia",10849,10794,10635,10560,10563,-231,-2.1292285003226104
".Polk County, Minnesota",31185,31076,30819,30725,30412,-664,-2.1292287958954623
".Armstrong County, Pennsylvania",65560,65470,65212,64704,64074,-1396,-2.12934716290421
".Copiah County, Mississippi",28369,28270,27922,27712,27664,-606,-2.1361345130247806
".Carlisle County, Kentucky",4820,4807,4761,4719,4704,-103,-2.136929460580913
".Muscatine County, Iowa",43240,43143,42674,42395,42218,-925,-2.1392229417206288
".Wayne County, Michigan",1793914,1789586,1774807,1758942,1751169,-38417,-2.1415184897380812
".Morgan County, Illinois",32920,32845,32646,32298,32140,-705,-2.1415552855407047
".Nobles County, Minnesota",22289,22205,22070,21958,21727,-478,-2.1445556103907757
".Wyandotte County, Kansas",169231,168914,167262,165626,165281,-3633,-2.146769799859364
".Bamberg County, South Carolina",13313,13260,13117,12950,12974,-286,-2.148276121084654
".Reynolds County, Missouri",6097,6081,6084,5996,5950,-131,-2.1485976709857306
".Christian County, Illinois",34039,33960,33703,33390,33228,-732,-2.150474455771321
".Crawford County, Pennsylvania",83938,83807,83209,82405,82001,-1806,-2.1515880769139124
".Menominee County, Michigan",23499,23451,23317,23225,22945,-506,-2.1532831184305716
".Jay County, Indiana",20471,20474,20282,20118,20032,-442,-2.1591519710810414
".Rock Island County, Illinois",144667,144360,142923,141559,141236,-3124,-2.159442028935417
".Crane County, Texas",4676,4675,4636,4551,4574,-101,-2.1599657827202736
".Hardin County, Iowa",16879,16828,16702,16614,16463,-365,-2.162450382131643
".Hale County, Texas",32526,32465,32208,31966,31761,-704,-2.1644223083072003
".Franklin Parish, Louisiana",19773,19713,19609,19358,19285,-428,-2.164567845041218
".McKean County, Pennsylvania",40430,40399,40317,39819,39519,-880,-2.1766015335147166
".Finney County, Kansas",38466,38304,38079,37639,37466,-838,-2.1785472885145323
".Cayuga County, New York",76253,76147,75451,74679,74485,-1662,-2.179586376929432
".Lewis County, Missouri",10032,10037,9994,9886,9818,-219,-2.1830143540669855
".Labette County, Kansas",20191,20170,19914,19702,19728,-442,-2.189094150859294
".Richardson County, Nebraska",7872,7862,7786,7730,7689,-173,-2.1976626016260163
".Clark County, Illinois",15463,15429,15352,15160,15088,-341,-2.2052641790079544
".Perkins County, Nebraska",2856,2858,2819,2827,2795,-63,-2.2058823529411766
".Worth County, Georgia",20774,20732,20565,20431,20273,-459,-2.20949263502455
".Franklin County, Nebraska",2889,2889,2878,2850,2825,-64,-2.215299411561094
".Prowers County, Colorado",12001,12017,11990,11873,11751,-266,-2.2164819598366803
".Fairfield County, South Carolina",20956,20887,20695,20450,20422,-465,-2.2189349112426036
".Greensville County, Virginia",11391,11386,11413,11204,11133,-253,-2.221051707488368
".Cross County, Arkansas",16828,16795,16672,16590,16420,-375,-2.2284288091276445
".Fayette County, Alabama",16326,16331,16127,16082,15967,-364,-2.229572461104986
".Clay County, Mississippi",18633,18622,18481,18311,18206,-416,-2.232598078677615
".Sweetwater County, Wyoming",42271,42197,41626,41374,41249,-948,-2.2426722812329967
".Webster County, Kentucky",13014,13018,12852,12739,12726,-292,-2.2437375134470567
".Greenbrier County, West Virginia",32973,32892,32687,32375,32149,-743,-2.2533588087222878
".Norton County, Kansas",5457,5453,5369,5325,5330,-123,-2.2539857064321054
".Clay County, Arkansas",14548,14529,14362,14271,14201,-328,-2.254605444047292
".Henry County, Virginia",50949,50851,50262,49795,49702,-1149,-2.255196372843432
".Wayne County, Illinois",16173,16126,15956,15843,15761,-365,-2.2568478328077664
".Honolulu County, Hawaii",1016507,1012399,1004163,994828,989408,-22991,-2.261765044411893
".St. Clair County, Illinois",257412,256844,254958,252265,251018,-5826,-2.26329774835672
".Hudson County, New Jersey",724858,721879,703448,702381,705472,-16407,-2.263477812205977
".Woodward County, Oklahoma",20477,20412,20241,20015,19947,-465,-2.2708404551447967
".Ward County, North Dakota",69926,69921,69364,68788,68332,-1589,-2.2724022538111717
".Cabell County, West Virginia",94347,94240,93408,92485,92082,-2158,-2.2873011330513955
".Eagle County, Colorado",55718,55657,55774,55218,54381,-1276,-2.290103736673965
".Adams County, Mississippi",29538,29423,28846,28517,28746,-677,-2.291962895253572
".Harrison County, Ohio",14485,14491,14458,14351,14159,-332,-2.292026234035209
".Martin County, North Carolina",22032,21952,21741,21478,21447,-505,-2.2921205519244734
".Foster County, North Dakota",3395,3387,3364,3380,3309,-78,-2.297496318114875
".Lamb County, Texas",13049,13011,12909,12786,12711,-300,-2.2990267453444706
".Cleveland County, Arkansas",7550,7552,7486,7467,7378,-174,-2.304635761589404
".San Miguel County, Colorado",8070,8054,8080,8008,7868,-186,-2.3048327137546467
".Quay County, New Mexico",8743,8712,8620,8529,8510,-202,-2.310419764382935
".Frio County, Texas",18386,18412,17543,17716,17987,-425,-2.3115413901881867
".Wilson County, Kansas",8629,8582,8520,8554,8382,-200,-2.31776567389037
".Koochiching County, Minnesota",12064,12031,11943,11848,11751,-280,-2.320954907161804
".Grant County, Oklahoma",4168,4180,4145,4122,4083,-97,-2.3272552783109406
".Cuyahoga County, Ohio",1264775,1262573,1247496,1236994,1233088,-29485,-2.3312446877903183
".Brown County, Kansas",9501,9472,9446,9373,9250,-222,-2.3365961477739186
".Rooks County, Kansas",4918,4893,4865,4810,4778,-115,-2.338348922326149
".Potter County, Pennsylvania",16397,16383,16311,16206,15999,-384,-2.3418918094773433
".Bethel Census Area, Alaska",18657,18661,18594,18259,18224,-437,-2.3422843972771616
".Caldwell Parish, Louisiana",9646,9615,9576,9493,9389,-226,-2.3429400787891352
".Johnson County, Kentucky",22679,22648,22548,22235,22116,-532,-2.34578244190661
".Renville County, Minnesota",14724,14694,14605,14473,14348,-346,-2.349904917142081
".Grenada County, Mississippi",21629,21577,21330,21134,21065,-512,-2.36719219566323
".Curry County, New Mexico",48426,48370,47936,47430,47222,-1148,-2.3706273489447818
".Milwaukee County, Wisconsin",939471,938550,924276,918078,916205,-22345,-2.3784661793711566
".Parmer County, Texas",9870,9854,9784,9649,9617,-237,-2.4012158054711246
".Marshall County, Minnesota",9033,9027,8997,8889,8810,-217,-2.4023026679951287
".Wells County, North Dakota",3987,3972,3903,3922,3876,-96,-2.407825432656132
".Mississippi County, Missouri",12573,12125,12105,11665,11822,-303,-2.409926031973276
".Monroe County, Alabama",19771,19706,19550,19412,19229,-477,-2.412624551110212
".Elk County, Pennsylvania",31000,30946,30796,30467,30198,-748,-2.412903225806452
".Inyo County, California",19018,18987,18924,18742,18527,-460,-2.4187611736249868
".Chenango County, New York",47220,47064,46569,46331,45920,-1144,-2.4227022448115205
".Garfield County, Nebraska",1815,1807,1833,1787,1763,-44,-2.4242424242424243
".Poinsett County, Arkansas",22965,22954,22691,22453,22397,-557,-2.425430002177226
".Potter County, South Dakota",2473,2473,2471,2446,2413,-60,-2.426202992317024
".Washington County, North Carolina",11004,10980,10883,10776,10713,-267,-2.42639040348964
".Ellis County, Oklahoma",3747,3739,3733,3683,3648,-91,-2.428609554310115
".Warren County, Pennsylvania",38585,38511,38161,37818,37572,-939,-2.4335881819359853
".Grant County, Kansas",7352,7326,7333,7250,7147,-179,-2.4347116430903157
".Chaves County, New Mexico",65156,65149,64650,63892,63561,-1588,-2.437227576892381
".Mercer County, West Virginia",59654,59519,59156,58612,58057,-1462,-2.4507996110906225
".Alexandria city, Virginia",159464,159139,155105,155045,155230,-3909,-2.4513369788792456
".Somerset County, Pennsylvania",74143,74019,72989,72629,72197,-1822,-2.4574133768528386
".Lafourche Parish, Louisiana",97565,97454,97599,95751,95056,-2398,-2.4578486137446833
".Bennett County, South Dakota",3375,3388,3389,3333,3305,-83,-2.4592592592592593
".Wise County, Virginia",36118,36064,35681,35327,35174,-890,-2.464145301511712
".Mendocino County, California",91590,91367,91321,90007,89108,-2259,-2.4664264657713724
".Stark County, North Dakota",33648,33832,33029,32718,33001,-831,-2.469686162624822
".Siskiyou County, California",44077,43995,44139,43786,42905,-1090,-2.4729450733942873
".Muscogee County, Georgia",206919,207006,205060,202432,201877,-5129,-2.4787477225387713
".Lane County, Kansas",1573,1568,1561,1544,1529,-39,-2.479338842975207
".Wilbarger County, Texas",12888,12842,12703,12535,12522,-320,-2.4829298572315333
".Orleans County, New York",40357,40135,39515,39163,39124,-1011,-2.5051416111207474
".Ochiltree County, Texas",10015,9955,9768,9692,9704,-251,-2.5062406390414376
".Big Horn County, Montana",13125,13080,12893,12826,12751,-329,-2.506666666666667
".Mason County, West Virginia",25451,25403,25266,24911,24765,-638,-2.506777729755216
".Keith County, Nebraska",8327,8322,8253,8179,8113,-209,-2.509907529722589
".Hitchcock County, Nebraska",2612,2618,2599,2614,2552,-66,-2.5267993874425727
".Allen Parish, Louisiana",22752,22687,22588,22287,22112,-575,-2.5272503516174405
".Halifax County, North Carolina",48625,48528,48353,47711,47298,-1230,-2.529562982005141
".Lowndes County, Mississippi",58881,58777,58160,57671,57283,-1494,-2.5373210373465125
".Scioto County, Ohio",74009,73848,72989,72189,71969,-1879,-2.538880406437055
".Vinton County, Ohio",12800,12801,12703,12577,12474,-327,-2.5546875
".Shelby County, Missouri",6102,6087,5965,5996,5931,-156,-2.55653883972468
".Mitchell County, Georgia",21763,21671,21318,21192,21114,-557,-2.5593897900105684
".Attala County, Mississippi",17886,17818,17715,17530,17359,-459,-2.5662529352566255
".Trego County, Kansas",2805,2803,2788,2746,2731,-72,-2.5668449197860963
".Menard County, Illinois",12295,12270,12167,12072,11954,-316,-2.570150467669784
".Prairie County, Arkansas",8287,8249,8095,8077,8036,-213,-2.5702908169421987
".Caddo County, Oklahoma",26944,26909,26461,26237,26214,-695,-2.579423990498812
".Pembina County, North Dakota",6847,6838,6773,6745,6661,-177,-2.585073754929166
".Gosper County, Nebraska",1895,1896,1829,1835,1847,-49,-2.5857519788918206
".Marion County, Illinois",37736,37652,37379,36905,36673,-979,-2.5943396226415096
".Grant County, New Mexico",28191,28205,27893,27693,27472,-733,-2.6001206058671205
".Hutchinson County, Texas",20613,20569,20438,20222,20033,-536,-2.600300781060496
".Eddy County, North Dakota",2342,2324,2324,2307,2263,-61,-2.604611443210931
".Columbia County, Arkansas",22800,22744,22490,22286,22150,-594,-2.6052631578947367
".Jim Hogg County, Texas",4835,4846,4790,4774,4720,-126,-2.605997931747673
".Rapides Parish, Louisiana",130013,129651,128626,127028,126260,-3391,-2.6082007183896994
".Trinity County, California",16114,16091,16082,15778,15670,-421,-2.612634975797443
".Clear Creek County, Colorado",9394,9393,9457,9367,9147,-246,-2.6186927826272086
".Union County, New Mexico",4082,4071,4096,3982,3964,-107,-2.621264086232239
".Audubon County, Iowa",5676,5683,5645,5575,5534,-149,-2.625088090204369
".Marin County, California",262321,261306,259278,256154,254407,-6899,-2.6299838747183792
".Nome Census Area, Alaska",10050,10029,9894,9791,9763,-266,-2.646766169154229
".Jefferson Davis County, Mississippi",11320,11269,11163,11079,10969,-300,-2.65017667844523
".Montgomery County, Kansas",31492,31404,31181,30853,30568,-836,-2.654642448875905
".Fulton County, Kentucky",6513,6511,6487,6371,6338,-173,-2.656226009519423
".Dickens County, Texas",1769,1758,1734,1736,1711,-47,-2.6568682871678915
".Wilkin County, Minnesota",6508,6479,6411,6358,6306,-173,-2.658266748617087
".Wibaux County, Montana",937,935,936,927,910,-25,-2.6680896478121667
".Glenn County, California",28921,28904,28718,28360,28129,-775,-2.679713702845683
".Edgar County, Illinois",16856,16786,16576,16385,16334,-452,-2.6815377313716184
".Logan County, Kansas",2758,2739,2710,2703,2665,-74,-2.6831036983321246
".Yoakum County, Texas",7694,7675,7563,7484,7468,-207,-2.6904081102157527
".Monroe County, Florida",82872,82847,82220,81618,80614,-2233,-2.6945168452553334
".Ida County, Iowa",7003,7022,6969,6905,6833,-189,-2.698843352848779
".Ohio County, West Virginia",42440,42341,41846,41463,41194,-1147,-2.7026390197926484
".Kossuth County, Iowa",14826,14799,14515,14465,14396,-403,-2.7181977606906784
".Roanoke city, Virginia",100014,99891,98700,97657,97171,-2720,-2.719619253304537
".Burke County, North Dakota",2197,2194,2154,2132,2134,-60,-2.730996813837051
".Jewell County, Kansas",2929,2927,2942,2885,2847,-80,-2.7313076135199728
".Raleigh County, West Virginia",74583,74394,73779,72801,72356,-2038,-2.7325261788879502
".Spink County, South Dakota",6355,6340,6261,6228,6166,-174,-2.738001573564123
".Logan County, Colorado",21536,21210,21006,20792,20619,-591,-2.7442421991084696
".Chickasaw County, Iowa",12011,11988,11883,11728,11658,-330,-2.747481475314295
".Clay County, West Virginia",8047,8005,7905,7840,7783,-222,-2.7587920964334534
".Knox County, Illinois",49958,49790,49310,48620,48411,-1379,-2.760318667680852
".Campbell County, South Dakota",1376,1378,1376,1355,1340,-38,-2.761627906976744
".Santa Clara County, California",1936279,1931168,1885173,1878335,1877592,-53576,-2.7669566214373034
".Bell County, Kentucky",24100,23984,23834,23611,23317,-667,-2.767634854771784
".Louisa County, Iowa",10830,10814,10724,10617,10513,-301,-2.7793167128347185
".Chemung County, New York",84142,83668,83039,81641,81325,-2343,-2.784578450714269
".Haywood County, Tennessee",17863,17826,17691,17518,17328,-498,-2.7878855735318813
".Loup County, Nebraska",609,609,604,601,592,-17,-2.7914614121510675
".Bailey County, Texas",6903,6866,6803,6803,6672,-194,-2.8103723018977256
".Fulton County, Illinois",33608,33487,33275,32935,32541,-946,-2.8148059985717686
".Clarke County, Alabama",23091,22987,22740,22574,22337,-650,-2.8149495474427266
".Nolan County, Texas",14734,14721,14605,14460,14306,-415,-2.8166146328220445
".McPherson County, South Dakota",2409,2402,2416,2396,2334,-68,-2.82274802822748
".Brooks County, Texas",7079,7048,6969,6902,6848,-200,-2.8252578047746857
".Otero County, Colorado",18687,18664,18527,18311,18136,-528,-2.825493658693209
".Buffalo County, South Dakota",1946,1939,1894,1854,1884,-55,-2.826310380267215
".Jefferson County, Nebraska",7240,7259,7159,7140,7054,-205,-2.8314917127071824
".Ramsey County, Minnesota",552355,551716,544025,537303,536075,-15641,-2.8316933855944093
".Monona County, Iowa",8753,8742,8598,8506,8493,-249,-2.844738946646864
".Worth County, Missouri",1968,1963,1967,1940,1907,-56,-2.8455284552845526
".Crawford County, Iowa",16519,16484,16232,16129,16013,-471,-2.851262182940856
".Bristol city, Virginia",17219,17299,17065,16940,16807,-492,-2.857308786805273
".Martin County, Kentucky",11290,11253,11165,11096,10928,-325,-2.878653675819309
".Norfolk city, Virginia",238003,237789,234862,232558,230930,-6859,-2.881896446683445
".Lee County, Iowa",33559,33533,33257,32829,32565,-968,-2.8844721237223996
".Corson County, South Dakota",3903,3895,3849,3817,3782,-113,-2.895208813733026
".Pleasants County, West Virginia",7650,7650,7604,7570,7428,-222,-2.9019607843137254
".Collingsworth County, Texas",2651,2640,2607,2585,2563,-77,-2.904564315352697
".Cavalier County, North Dakota",3716,3704,3680,3608,3596,-108,-2.906350914962325
".Wrangell City and Borough, Alaska",2125,2126,2102,2071,2064,-62,-2.9176470588235293
".Natchitoches Parish, Louisiana",37516,37387,36973,36648,36291,-1096,-2.921420194050538
".Dougherty County, Georgia",85793,85155,82235,82895,82645,-2510,-2.9256466145256605
".Hinsdale County, Colorado",784,788,773,771,765,-23,-2.933673469387755
".White County, Illinois",13872,13808,13758,13595,13401,-407,-2.9339677047289503
".Lauderdale County, Mississippi",72981,72675,71937,71142,70527,-2148,-2.9432318000575495
".Marlboro County, South Carolina",26669,26490,26235,26006,25704,-786,-2.947242116314823
".Choctaw County, Alabama",12669,12626,12548,12431,12252,-374,-2.9520877733049176
".Kleberg County, Texas",31042,30986,30625,30376,30069,-917,-2.9540622382578445
".Benton County, Mississippi",7646,7664,7638,7556,7438,-226,-2.955793879152498
".Red River Parish, Louisiana",7619,7582,7505,7465,7356,-226,-2.96626853917837
".Lawrence County, Illinois",15292,15268,15228,14891,14813,-455,-2.9754119801203247
".Summers County, West Virginia",11967,11939,11865,11702,11581,-358,-2.9915601236734353
".Union County, Illinois",17239,17184,16921,16772,16667,-517,-2.9990138639132202
".Kanawha County, West Virginia",180749,180233,178073,175864,174805,-5428,-3.003059491338818
".Barber County, Kansas",4228,4198,4099,4124,4071,-127,-3.0037842951750235
".McCone County, Montana",1726,1728,1709,1711,1676,-52,-3.0127462340672073
".Ziebach County, South Dakota",2414,2395,2385,2394,2322,-73,-3.024026512013256
".Cass County, Illinois",13049,12991,12790,12638,12596,-395,-3.02705188137022
".Ritchie County, West Virginia",8446,8423,8410,8230,8167,-256,-3.0310206014681507
".Marengo County, Alabama",19325,19270,18985,18791,18684,-586,-3.0323415265200517
".Stark County, Illinois",5395,5382,5284,5313,5218,-164,-3.03985171455051
".Macon County, Illinois",103984,103752,102597,101333,100591,-3161,-3.03989075242345
".Wayne County, West Virginia",38988,38873,38564,37980,37686,-1187,-3.0445265209808148
".Neosho County, Kansas",15900,15905,15787,15583,15420,-485,-3.050314465408805
".Lewis County, West Virginia",17031,17020,16874,16674,16500,-520,-3.0532558276084787
".Thurston County, Nebraska",6779,6764,6633,6555,6557,-207,-3.053547720902788
".Claiborne Parish, Louisiana",14168,14103,14043,13849,13670,-433,-3.056182947487295
".Rio Grande County, Colorado",11541,11541,11406,11337,11188,-353,-3.0586604280391647
".Baltimore city, Maryland",585690,583157,576578,569107,565239,-17918,-3.059297580631392
".Potter County, Texas",118522,118275,116461,114911,114647,-3628,-3.061035082094463
".Noxubee County, Mississippi",10279,10229,10116,10000,9914,-315,-3.0645004377857767
".Hancock County, West Virginia",29093,29038,28595,28254,28145,-893,-3.0694668820678515
".Dickenson County, Virginia",14128,14074,13860,13733,13640,-434,-3.0719139297848246
".Napa County, California",138013,137459,136265,134370,133216,-4243,-3.074348068660199
".Grant County, North Dakota",2299,2286,2303,2238,2215,-71,-3.088299260548064
".Plumas County, California",19794,19746,19958,19443,19131,-615,-3.107002121855108
".Wichita County, Kansas",2153,2149,2080,2078,2082,-67,-3.1119368323269856
".Avoyelles Parish, Louisiana",39692,39646,39261,38715,38408,-1238,-3.119016426483926
".Philadelphia County, Pennsylvania",1603793,1600684,1589623,1566836,1550542,-50142,-3.12646332787336
".Iroquois County, Illinois",27082,26984,26775,26493,26136,-848,-3.1312310759914337
".Stephenson County, Illinois",44631,44503,44062,43556,43105,-1398,-3.132351952678632
".Sullivan County, Missouri",5997,5985,5898,5816,5797,-188,-3.134900783725196
".Jefferson County, Georgia",15710,15676,15476,15294,15183,-493,-3.1381285805219608
".Lafayette County, Arkansas",6305,6293,6159,6129,6095,-198,-3.140364789849326
".Richland County, Montana",11494,11534,11329,11230,11173,-361,-3.1407690969201325
".Stevens County, Kansas",5249,5243,5302,5166,5077,-166,-3.1625071442179467
".Vermilion County, Illinois",74204,74009,73164,72103,71652,-2357,-3.176378631879683
".Tazewell County, Virginia",40437,40407,39950,39563,39120,-1287,-3.1827286890718898
".Bath County, Virginia",4204,4185,4090,4061,4051,-134,-3.1874405328258804
".Divide County, North Dakota",2195,2205,2182,2169,2135,-70,-3.189066059225513
".Benson County, North Dakota",5954,5935,5773,5772,5745,-190,-3.191132012092711
".Charlottesville city, Virginia",46553,46469,45746,45272,44983,-1486,-3.1920606620411145
".Bullock County, Alabama",10360,10229,10143,10143,9897,-332,-3.2046332046332044
".Lincoln County, Colorado",5674,5662,5473,5510,5480,-182,-3.2076136764187524
".Hempstead County, Arkansas",20069,19989,19667,19481,19343,-646,-3.2188948128955106
".Magoffin County, Kentucky",11638,11603,11489,11348,11228,-375,-3.2222031276851695
".Lincoln County, West Virginia",20456,20363,20188,19851,19701,-662,-3.2362143136488073
".Cameron County, Pennsylvania",4542,4527,4458,4406,4380,-147,-3.2364597093791283
".Pointe Coupee Parish, Louisiana",20755,20673,20346,20212,20000,-673,-3.24259214647073
".Clay County, Kentucky",20339,20312,20161,19874,19648,-664,-3.2646639461133784
".Conecuh County, Alabama",11597,11554,11320,11224,11174,-380,-3.2767094938346126
".Sheridan County, Nebraska",5125,5096,5083,5006,4928,-168,-3.278048780487805
".Greene County, Illinois",11987,11936,11847,11640,11543,-393,-3.2785517644114455
".Multnomah County, Oregon",815418,816514,805319,794563,789698,-26816,-3.28862006970658
".Yazoo County, Mississippi",26751,26676,26424,25893,25796,-880,-3.2895966505925007
".Los Angeles County, California",10013976,9992813,9809462,9719765,9663345,-329468,-3.2900817817018937
".Kiowa County, Kansas",2461,2455,2409,2405,2374,-81,-3.29134498171475
".Santa Cruz County, California",270870,270474,260475,264240,261547,-8927,-3.2956768929744897
".Williamsburg County, South Carolina",31023,30914,30418,30113,29891,-1023,-3.2975534281017307
".Eddy County, New Mexico",62314,62333,60855,60203,60275,-2058,-3.302628622781397
".Guadalupe County, New Mexico",4450,4439,4423,4316,4292,-147,-3.3033707865168536
".Wabash County, Illinois",11362,11318,11208,11040,10942,-376,-3.309276535821158
".Massac County, Illinois",14170,14133,13946,13827,13661,-472,-3.330980945659845
".Cook County, Illinois",5275555,5263608,5180919,5111566,5087072,-176536,-3.346301953064654
".Fayette County, West Virginia",40483,40428,40036,39388,39072,-1356,-3.349554133833955
".Yukon-Koyukuk Census Area, Alaska",5351,5309,5278,5169,5129,-180,-3.3638572229489814
".Lincoln County, Nebraska",34674,34532,34074,33614,33365,-1167,-3.365634192766915
".Harmon County, Oklahoma",2490,2476,2403,2416,2392,-84,-3.3734939759036147
".Butler County, Alabama",19046,19025,18890,18668,18382,-643,-3.376036963141867
".Iberia Parish, Louisiana",70288,70055,69325,68320,67659,-2396,-3.408832233098111
".Lea County, New Mexico",74457,74642,73062,72343,72101,-2541,-3.4127080059631734
".Hansford County, Texas",5273,5252,5120,5111,5071,-181,-3.4325810733927558
".Nance County, Nebraska",3376,3390,3375,3317,3274,-116,-3.4360189573459716
".Saline County, Illinois",23772,23690,23316,23052,22873,-817,-3.436816422682147
".Haskell County, Kansas",3781,3760,3652,3595,3630,-130,-3.438243850833113
".Stafford County, Kansas",4064,4049,4008,3971,3909,-140,-3.4448818897637796
".Seneca County, New York",33816,33516,33414,32586,32349,-1167,-3.4510290986515257
".Chippewa County, Minnesota",12605,12608,12372,12269,12172,-436,-3.458944863149544
".Lee County, South Carolina",16531,16539,16272,16161,15967,-572,-3.460165749198475
".Alameda County, California",1682349,1680466,1644047,1628259,1622188,-58278,-3.4640850382411736
".Lawrence County, Ohio",58232,58137,57408,56572,56118,-2019,-3.4671658194806976
".Wheeler County, Texas",4988,4977,4886,4787,4804,-173,-3.468323977546111
".Covington city, Virginia",5747,5745,5716,5633,5545,-200,-3.480076561684357
".Kearny County, Kansas",3982,3962,3897,3865,3823,-139,-3.490708186840784
".McPherson County, Nebraska",400,397,381,379,383,-14,-3.5000000000000004
".Kittson County, Minnesota",4227,4208,4178,4086,4060,-148,-3.5013011592145733
".Knott County, Kentucky",14246,14158,14032,13847,13659,-499,-3.5027376105573493
".Crosby County, Texas",5129,5098,5085,4992,4917,-181,-3.528953012283096
".Socorro County, New Mexico",16594,16551,16291,16111,15963,-588,-3.543449439556466
".Osceola County, Iowa",6191,6198,6170,6072,5978,-220,-3.553545469229527
".Marshall County, West Virginia",30583,30494,30164,29667,29405,-1089,-3.5608017526076576
".McKenzie County, North Dakota",14708,14776,13858,13889,14252,-524,-3.562686973075877
".Wetzel County, West Virginia",14453,14405,14202,13994,13890,-515,-3.5632740607486335
".Kimball County, Nebraska",3439,3412,3411,3336,3289,-123,-3.57662111078802
".Suffolk County, Massachusetts",800930,797181,774514,768812,768425,-28756,-3.590326245739328
".Mellette County, South Dakota",1919,1920,1898,1873,1851,-69,-3.595622720166754
".Seward County, Kansas",21963,21857,21763,21345,21067,-790,-3.596958521149205
".St. Charles Parish, Louisiana",52548,52513,52470,51058,50620,-1893,-3.602420643982644
".Zavala County, Texas",9668,9661,9473,9384,9312,-349,-3.6098469176665287
".Wirt County, West Virginia",5197,5188,5066,5092,5000,-188,-3.617471618241293
".Fayette County, Pennsylvania",128825,128588,127122,125368,123915,-4673,-3.6274015136813507
".Ouachita County, Arkansas",22647,22615,22312,21994,21793,-822,-3.6296198171943304
".North Slope Borough, Alaska",11032,11004,11054,10811,10603,-401,-3.6348803480783176
".Ashley County, Arkansas",19058,18957,18654,18348,18262,-695,-3.6467625144296356
".Del Norte County, California",27745,27604,27584,27112,26589,-1015,-3.6583168138403317
".Rush County, Kansas",2951,2938,2928,2941,2830,-108,-3.6597763470010167
".Winn Parish, Louisiana",13753,13720,13493,13251,13216,-504,-3.6646549843670475
".Hooker County, Nebraska",709,705,732,682,679,-26,-3.6671368124118473
".Kodiak Island Borough, Alaska",13100,13047,12878,12639,12565,-482,-3.6793893129770994
".Meade County, Kansas",4062,4061,3997,3913,3911,-150,-3.6927621861152145
".Bradley County, Arkansas",10545,10495,10343,10168,10104,-391,-3.7079184447605504
".Pecos County, Texas",15198,15187,15117,14711,14623,-564,-3.7110146071851555
".Webster County, West Virginia",8379,8356,8271,8141,8045,-311,-3.711660102637546
".Dimmit County, Texas",8613,8579,8479,8360,8257,-322,-3.7385347730175313
".Sedgwick County, Colorado",2401,2389,2326,2286,2299,-90,-3.7484381507705127
".Atchison County, Missouri",5304,5306,5210,5161,5107,-199,-3.7518853695324283
".McHenry County, North Dakota",5352,5332,5238,5195,5131,-201,-3.755605381165919
".Sumter County, Alabama",12344,12191,11967,11889,11727,-464,-3.7589112119248216
".Dawson County, Texas",12459,12474,12367,12176,12004,-470,-3.7723733847018224
".Bowman County, North Dakota",2992,2980,2900,2899,2867,-113,-3.776737967914438
".Warren County, Illinois",16833,16821,16585,16360,16185,-636,-3.778292639458207
".Lee County, Arkansas",8593,8526,8560,8367,8201,-325,-3.7821482602118004
".Baker County, Georgia",2875,2852,2824,2792,2743,-109,-3.791304347826087
".Thayer County, Nebraska",5033,5020,4888,4854,4829,-191,-3.7949533081661038
".Hartley County, Texas",5375,5349,5393,5228,5145,-204,-3.7953488372093025
".Pershing County, Nevada",6646,6617,6427,6450,6364,-253,-3.806801083358411
".Rolette County, North Dakota",12190,12193,12067,11867,11728,-465,-3.814602132895816
".Assumption Parish, Louisiana",21046,20963,20696,20463,20160,-803,-3.8154518673382114
".West Carroll Parish, Louisiana",9757,9696,9583,9481,9323,-373,-3.822896382084657
".Floyd County, Kentucky",35941,35798,35304,34918,34423,-1375,-3.825714365209649
".Kent County, Texas",755,763,748,744,734,-29,-3.8410596026490067
".Edwards County, Illinois",6245,6208,6084,6058,5968,-240,-3.843074459567654
".Alleghany County, Virginia",15211,15180,14988,14715,14595,-585,-3.8459009927026493
".Calhoun County, West Virginia",6227,6199,6173,6069,5959,-240,-3.854183394893207
".Motley County, Texas",1061,1061,1071,1034,1020,-41,-3.8642789820923658
".Henderson County, Illinois",6385,6335,6306,6168,6088,-247,-3.8684416601409555
".Baca County, Colorado",3508,3480,3490,3435,3344,-136,-3.8768529076396807
".Monroe County, Arkansas",6802,6776,6648,6568,6512,-264,-3.8812114084092917
".Roger Mills County, Oklahoma",3440,3429,3365,3337,3295,-134,-3.8953488372093026
".Union County, Arkansas",39050,38931,38375,37813,37397,-1534,-3.928297055057618
".Arthur County, Nebraska",430,429,432,425,412,-17,-3.953488372093023
".St. Francis County, Arkansas",23094,23021,22715,22402,22101,-920,-3.9837187148177016
".Carroll County, Mississippi",9999,9934,9822,9736,9535,-399,-3.9903990399039904
".Sherman County, Texas",2781,2789,2789,2778,2678,-111,-3.9913700107874863
".Union County, Kentucky",13670,13652,13254,13104,13106,-546,-3.994147768836869
".Dallas County, Arkansas",6481,6444,6309,6196,6185,-259,-3.99629686776732
".Sutton County, Texas",3373,3356,3291,3232,3221,-135,-4.00237177586718
".Twiggs County, Georgia",8024,8013,7881,7676,7691,-322,-4.012961116650049
".Phillips County, Kansas",4973,4961,4819,4783,4761,-200,-4.021717273275689
".Calhoun County, Mississippi",13263,13219,12961,12846,12685,-534,-4.026238407600091
".Niobrara County, Wyoming",2471,2454,2416,2348,2354,-100,-4.046944556859571
".Hoonah-Angoon Census Area, Alaska",2360,2358,2330,2279,2262,-96,-4.067796610169491
".Jefferson Parish, Louisiana",440783,439725,434134,426030,421777,-17948,-4.07184487605012
".Miller County, Georgia",6000,5992,5853,5774,5747,-245,-4.083333333333333
".Mason County, Illinois",13091,13058,12830,12699,12523,-535,-4.086777175158505
".Lipscomb County, Texas",3054,3031,2895,2846,2906,-125,-4.092992796332679
".Slope County, North Dakota",708,703,696,682,674,-29,-4.096045197740112
".Northampton County, North Carolina",17469,17433,17116,16827,16715,-718,-4.110137958669643
".Pitkin County, Colorado",17358,17355,17337,16847,16640,-715,-4.119138149556401
".Mountrail County, North Dakota",9794,9788,9562,9241,9383,-405,-4.135184807024709
".Woodruff County, Arkansas",6272,6224,6146,6057,5964,-260,-4.145408163265306
".Clearfield County, Pennsylvania",80551,80432,78335,77824,77090,-3342,-4.148924283993991
".Kemper County, Mississippi",8983,8960,8801,8670,8584,-376,-4.18568406990983
".Dunklin County, Missouri",28285,28217,27743,27411,27032,-1185,-4.189499734841789
".Jefferson County, Mississippi",7256,7245,7136,7067,6941,-304,-4.189636163175303
".Boyd County, Nebraska",1810,1801,1780,1730,1725,-76,-4.198895027624309
".Greene County, Pennsylvania",35953,35868,35284,34529,34357,-1511,-4.202709092426224
".Pike County, Kentucky",58663,58441,57416,56317,55973,-2468,-4.207081124388456
".Chase County, Nebraska",3895,3888,3824,3754,3724,-164,-4.2105263157894735
".Scott County, Kansas",5152,5139,5121,5007,4922,-217,-4.211956521739131
".Bienville Parish, Louisiana",12983,12913,12779,12612,12366,-547,-4.213201879380728
".Dewey County, Oklahoma",4482,4475,4418,4404,4286,-189,-4.216867469879518
".Wolfe County, Kentucky",6564,6559,6507,6416,6282,-277,-4.219987812309568
".St. Mary Parish, Louisiana",49398,49142,48219,47819,47055,-2087,-4.224867403538605
".Emporia city, Virginia",5764,5707,5638,5533,5463,-244,-4.233171408743928
".Rawlins County, Kansas",2566,2572,2558,2523,2463,-109,-4.247856586126267
".Cimarron County, Oklahoma",2292,2289,2247,2233,2191,-98,-4.275741710296685
".Texas County, Oklahoma",21383,21289,20849,20505,20371,-918,-4.2931300565870085
".Scurry County, Texas",16933,16942,16837,16269,16212,-730,-4.311108486387527
".Perry County, Kentucky",28470,28367,27927,27367,27133,-1234,-4.334387074113102
".Winkler County, Texas",7791,7754,7382,7300,7414,-340,-4.364009754845334
".Chugach Census Area, Alaska",7103,7080,6971,6899,6769,-311,-4.378431648599183
".Henry County, Iowa",20482,20447,20382,20253,19547,-900,-4.39410213846304
".Kusilvak Census Area, Alaska",8370,8371,8377,8214,8001,-370,-4.4205495818399045
".Caddo Parish, Louisiana",237865,236945,232658,228934,226386,-10559,-4.439072583187943
".Harding County, New Mexico",653,653,631,621,624,-29,-4.44104134762634
".Morton County, Kansas",2700,2700,2671,2601,2580,-120,-4.444444444444445
".Webster Parish, Louisiana",36966,36883,35938,35527,35238,-1645,-4.450035167451171
".Adams County, Iowa",3707,3709,3638,3601,3544,-165,-4.451038575667656
".Roosevelt County, Montana",10798,10801,10788,10537,10319,-482,-4.463789590664938
".Tyler County, West Virginia",8304,8291,8205,8090,7919,-372,-4.479768786127168
".Randolph County, Georgia",6421,6368,6263,6126,6078,-290,-4.5164304625447755
".Plaquemines Parish, Louisiana",23515,23460,23310,22618,22386,-1074,-4.567297469700192
".Terrell County, Georgia",9184,9140,8924,8792,8718,-422,-4.594947735191638
".St. James Parish, Louisiana",20197,20120,19794,19388,19191,-929,-4.5996930237163935
".Mississippi County, Arkansas",40682,40538,39534,38863,38663,-1875,-4.608917948970061
".Greene County, Alabama",7731,7700,7614,7452,7341,-359,-4.64364247833398
".Manassas Park city, Virginia",17217,17162,17089,16693,16361,-801,-4.652378463146889
".Geary County, Kansas",36735,36760,36116,35529,35047,-1713,-4.663127807268273
".Arkansas County, Arkansas",17148,17107,16687,16498,16307,-800,-4.665267086540704
".Scott County, Illinois",4947,4941,4849,4771,4710,-231,-4.66949666464524
".New York County, New York",1694250,1677232,1578055,1594543,1597451,-79781,-4.708927253947174
".Jefferson County, Arkansas",67258,66830,65637,64295,63661,-3169,-4.711707157512861
".Concordia Parish, Louisiana",18680,18569,18348,18026,17688,-881,-4.7162740899357605
".San Mateo County, California",764432,762479,739149,728929,726353,-36126,-4.72586181635515
".Dillingham Census Area, Alaska",4856,4838,4796,4724,4607,-231,-4.757001647446458
".Hidalgo County, New Mexico",4179,4164,4086,4011,3965,-199,-4.761904761904762
".Hodgeman County, Kansas",1721,1737,1724,1697,1655,-82,-4.764671702498547
".Pulaski County, Illinois",5190,5160,5075,4950,4911,-249,-4.797687861271676
".Kingman County, Kansas",7473,7425,7291,7174,7066,-359,-4.803960926000268
".Catahoula Parish, Louisiana",8905,8844,8721,8604,8414,-430,-4.828747894441325
".Letcher County, Kentucky",21550,21465,21224,20827,20423,-1042,-4.835266821345708
".McMullen County, Texas",599,597,592,569,568,-29,-4.841402337228715
".Vernon Parish, Louisiana",48745,48622,48022,46870,46250,-2372,-4.86614011693507
".Wyoming County, West Virginia",21389,21322,21029,20572,20277,-1045,-4.885688905512179
".Brooke County, West Virginia",22551,22476,22068,21694,21373,-1103,-4.89113564808656
".Kiowa County, Colorado",1448,1455,1454,1434,1384,-71,-4.903314917127072
".Garden County, Nebraska",1873,1886,1838,1835,1794,-92,-4.9119060331019755
".Wheeler County, Georgia",7480,7449,7737,7310,7081,-368,-4.919786096256685
".Orleans Parish, Louisiana",383997,383241,377346,369917,364136,-19105,-4.975299286192341
".Warren County, Mississippi",44715,44544,43430,42635,42298,-2246,-5.022922956502293
".Williams County, North Dakota",40945,41182,38499,37966,39113,-2069,-5.05312003907681
".Jackson County, Colorado",1381,1379,1359,1314,1309,-70,-5.068790731354091
".Hyde County, South Dakota",1261,1250,1230,1199,1186,-64,-5.07533703409992
".Tunica County, Mississippi",9787,9733,9642,9407,9234,-499,-5.0986001839174415
".Presidio County, Texas",6133,6108,6113,5954,5795,-313,-5.103538235773683
".Norton city, Virginia",3697,3681,3632,3589,3492,-189,-5.1122531782526375
".Cottle County, Texas",1379,1365,1355,1317,1294,-71,-5.148658448150834
".Logan County, West Virginia",32574,32514,31846,31206,30827,-1687,-5.1789770982992565
".Floyd County, Texas",5397,5370,5292,5239,5090,-280,-5.188067444876784
".Hemphill County, Texas",3384,3365,3324,3225,3189,-176,-5.200945626477541
".Edwards County, Kansas",2903,2884,2802,2760,2733,-151,-5.201515673441268
".McKinley County, New Mexico",72904,72590,71464,69931,68797,-3793,-5.202732360364315
".Dallas County, Alabama",38458,38171,37515,36729,36165,-2006,-5.2160798793489
".Hinds County, Mississippi",227741,226765,222464,217555,214870,-11895,-5.223038451574377
".Bertie County, North Carolina",17934,17863,17371,17068,16922,-941,-5.247016839522694
".Claiborne County, Mississippi",9135,9097,8886,8775,8617,-480,-5.254515599343185
".Terrebonne Parish, Louisiana",109577,109405,108955,104632,103616,-5789,-5.283042974346806
".Alpine County, California",1202,1205,1229,1190,1141,-64,-5.324459234608985
".Harlan County, Kentucky",26833,26754,26150,25652,25324,-1430,-5.329258748555882
".Sunflower County, Mississippi",25972,25856,25329,24837,24468,-1388,-5.344216848914216
".Boone County, West Virginia",21809,21744,21353,20907,20576,-1168,-5.355587142922646
".Gallatin County, Illinois",4944,4935,4895,4823,4670,-265,-5.360032362459547
".Coahoma County, Mississippi",21385,21224,20721,20235,20077,-1147,-5.363572597615151
".Issaquena County, Mississippi",1338,1328,1294,1262,1256,-72,-5.381165919282512
".Breathitt County, Kentucky",13715,13693,13546,13358,12953,-740,-5.395552314983595
".Towner County, North Dakota",2163,2147,2128,2060,2030,-117,-5.409153952843273
".Wilkinson County, Mississippi",8587,8526,8305,8203,8058,-468,-5.4500989868405725
".Irwin County, Georgia",9663,9647,9369,9114,9120,-527,-5.453792817965435
".New Madrid County, Missouri",16428,16325,16035,15710,15424,-901,-5.484538592646701
".Lowndes County, Alabama",10321,10285,9945,9783,9717,-568,-5.5033426993508385
".Wilcox County, Alabama",10598,10534,10423,10139,9944,-590,-5.567088129835819
".Northwest Arctic Borough, Alaska",7796,7797,7635,7453,7361,-436,-5.592611595690097
".Macon County, Alabama",19527,19464,18905,18532,18370,-1094,-5.602499103804988
".Dundy County, Nebraska",1657,1654,1633,1595,1561,-93,-5.612552806276403
".Queens County, New York",2405425,2388864,2329008,2278558,2252196,-136668,-5.681657087624848
".Buchanan County, Virginia",20343,20245,19876,19383,19087,-1158,-5.692375755788231
".Leslie County, Kentucky",10513,10468,10280,10049,9864,-604,-5.745267763721107
".Kings County, New York",2736119,2718447,2637522,2589531,2561225,-157222,-5.746168203941422
".Upton County, Texas",3306,3299,3233,3146,3109,-190,-5.747126436781609
".Calcasieu Parish, Louisiana",216783,216481,204914,202288,203761,-12720,-5.867618770844577
".Morehouse Parish, Louisiana",25638,25465,25021,24414,23955,-1510,-5.889694984008113
".White Pine County, Nevada",9076,9059,8844,8746,8522,-537,-5.916703393565447
".Washington County, Mississippi",44922,44640,43626,42524,41946,-2694,-5.997061573393882
".Bolivar County, Mississippi",30980,30835,30201,29461,28968,-1867,-6.026468689477082
".Chicot County, Arkansas",10211,10156,10052,9834,9538,-618,-6.052296542943885
".Ward County, Texas",11640,11674,11081,10948,10966,-708,-6.082474226804123
".Sioux County, North Dakota",3896,3880,3747,3686,3643,-237,-6.083162217659138
".Mingo County, West Virginia",23573,23488,23052,22445,22023,-1465,-6.214737199338225
".St. Louis city, Missouri",301565,300496,293622,286193,281754,-18742,-6.214912207981695
".Pemiscot County, Missouri",15662,15588,15241,14865,14613,-975,-6.225258587664411
".Tallahatchie County, Mississippi",12712,12648,12305,12067,11837,-811,-6.379798615481434
".Leflore County, Mississippi",28342,28188,27425,26664,26378,-1810,-6.386281843200903
".Jeff Davis County, Texas",1998,1984,1959,1906,1856,-128,-6.406406406406406
".Traverse County, Minnesota",3357,3354,3272,3242,3136,-218,-6.493893357164135
".Holmes County, Mississippi",17003,16882,16508,16111,15777,-1105,-6.498853143562901
".St. John the Baptist Parish, Louisiana",42481,42366,42109,39955,39592,-2774,-6.529978107859985
".Clark County, Kansas",1992,1979,1958,1939,1847,-132,-6.626506024096386
".Humphreys County, Mississippi",7795,7740,7566,7354,7216,-524,-6.722257857601026
".Madison Parish, Louisiana",10017,9927,9801,9480,9246,-681,-6.798442647499252
".Allendale County, South Carolina",8046,7934,7714,7418,7369,-565,-7.022122793934875
".San Francisco County, California",873950,870518,811935,807774,808988,-61530,-7.0404485382458954
".Reagan County, Texas",3385,3380,3222,3121,3141,-239,-7.06056129985229
".Bronx County, New York",1472653,1461151,1424084,1381808,1356476,-104675,-7.10792019572839
".Greeley County, Kansas",1282,1274,1282,1232,1181,-93,-7.254290171606864
".Forest County, Pennsylvania",6973,6958,6890,6603,6449,-509,-7.299584110139108
".Desha County, Arkansas",11398,11324,11048,10758,10479,-845,-7.413581330057904
".Crockett County, Texas",3096,3093,3013,2960,2858,-235,-7.590439276485789
".East Carroll Parish, Louisiana",7459,7397,7229,6939,6829,-568,-7.614961791124816
".Jones County, South Dakota",920,926,879,875,855,-71,-7.717391304347826
".McDowell County, West Virginia",19115,18935,18406,17806,17439,-1496,-7.826314412764844
".Grant County, Nebraska",611,613,577,584,565,-48,-7.855973813420622
".Lake and Peninsula Borough, Alaska",1474,1450,1419,1377,1331,-119,-8.07327001356852
".Tensas Parish, Louisiana",4147,4107,4024,3814,3764,-343,-8.271039305522065
".Terrell County, Texas",760,750,721,688,687,-63,-8.289473684210526
".Logan County, Nebraska",718,715,685,685,655,-60,-8.356545961002785
".Perry County, Alabama",8513,8458,8328,7904,7738,-720,-8.45765300129214
".Chattahoochee County, Georgia",9566,9475,9044,8746,8661,-814,-8.509303784235835
".Stanton County, Kansas",2085,2084,2045,1967,1901,-183,-8.776978417266188
".Phillips County, Arkansas",16571,16440,15825,15350,14961,-1479,-8.925230824935127
".Hertford County, North Carolina",21553,21378,19953,19634,19453,-1925,-8.931471256901592
".Alexander County, Illinois",5239,5169,5025,4841,4695,-474,-9.047528154227907
".Lake County, Tennessee",7009,6995,6596,6500,6347,-648,-9.245256099300898
".Quitman County, Mississippi",6177,6159,5900,5674,5546,-613,-9.923911283794723
".Lassen County, California",32733,32315,31885,30020,28861,-3454,-10.552042281489628
".Borden County, Texas",629,642,618,580,572,-70,-11.128775834658187
".Sharkey County, Mississippi",3801,3772,3626,3462,3336,-436,-11.470665614312022
".Skagway Municipality, Alaska",1240,1238,1147,1092,1095,-143,-11.53225806451613
".Stewart County, Georgia",5314,5303,4915,4604,4674,-629,-11.836657884832517
".Howard County, Texas",34866,34816,34365,30732,30554,-4262,-12.223943096426318
".Telfair County, Georgia",12476,12465,12317,12378,10920,-1545,-12.383776851554986
".Cameron Parish, Louisiana",5619,5623,5094,4896,4768,-855,-15.216230646022424
".DeKalb County, Missouri",11034,11599,11690,11310,9899,-1700,-15.406924052927314
".King County, Texas",263,267,256,234,217,-50,-19.011406844106464
".Reeves County, Texas",14743,14768,12981,11692,11770,-2998,-20.33507427253612
".Garza County, Texas",5817,5817,6269,4498,4517,-1300,-22.348289496303934
".Loving County, Texas",63,65,54,44,43,-22,-34.92063492063492
